"state","cty","countyfips","Obama","Romney","pctObama","diff2012"
"AK","Alaska","02000",102138,136848,0.427380683387311,-34710
"AL","Autauga","01001",6354,17366,0.26787521079258,-11012
"AL","Baldwin","01003",18329,65772,0.217940333646449,-47443
"AL","Barbour","01005",5873,5539,0.514633718892394,334
"AL","Bibb","01007",2200,6131,0.264073940703397,-3931
"AL","Blount","01009",2961,20741,0.124926166568222,-17780
"AL","Bullock","01011",4058,1250,0.764506405425772,2808
"AL","Butler","01013",4367,5081,0.462214225232853,-714
"AL","Calhoun","01015",15500,30272,0.338634973346151,-14772
"AL","Chambers","01017",6853,7596,0.474288878123053,-743
"AL","Cherokee","01019",2126,7494,0.220997920997921,-5368
"AL","Chilton","01021",3391,13910,0.196000231200509,-10519
"AL","Choctaw","01023",3785,4150,0.477000630119723,-365
"AL","Clarke","01025",6317,7463,0.458417997097242,-1146
"AL","Clay","01027",1770,4802,0.269324406573341,-3032
"AL","Cleburne","01029",971,5269,0.155608974358974,-4298
"AL","Coffee","01031",4899,14638,0.250754977734555,-9739
"AL","Colbert","01033",9160,13931,0.396691351608852,-4771
"AL","Conecuh","01035",3551,3434,0.508375089477452,117
"AL","Coosa","01037",2188,3028,0.419478527607362,-840
"AL","Covington","01039",3155,12148,0.206168725086584,-8993
"AL","Crenshaw","01041",2048,4326,0.321305302792595,-2278
"AL","Cullman","01043",4855,27930,0.148086014945859,-23075
"AL","Dale","01045",5283,13105,0.287306939308245,-7822
"AL","Dallas","01047",14599,6284,0.699085380453,8315
"AL","DeKalb","01049",5235,18316,0.222283554838436,-13081
"AL","Elmore","01051",8940,26223,0.254244518385803,-17283
"AL","Escambia","01053",5476,9263,0.371531311486532,-3787
"AL","Etowah","01055",12792,29102,0.305342053754714,-16310
"AL","Fayette","01057",1803,6034,0.230062523924971,-4231
"AL","Franklin","01059",3171,7567,0.295306388526728,-4396
"AL","Geneva","01061",2039,9173,0.181858722797003,-7134
"AL","Greene","01063",4514,799,0.84961415396198,3715
"AL","Hale","01065",5401,3205,0.627585405531025,2196
"AL","Henry","01067",3046,5605,0.352098023349902,-2559
"AL","Houston","01069",12348,29214,0.297098310957124,-16866
"AL","Jackson","01071",5817,14422,0.287415386135679,-8605
"AL","Jefferson","01073",159658,141413,0.530300161755865,18245
"AL","Lamar","01075",1643,5453,0.231538895152198,-3810
"AL","Lauderdale","01077",12504,23902,0.343459869252321,-11398
"AL","Lawrence","01079",5055,8855,0.363407620416966,-3800
"AL","Lee","01081",21274,32062,0.398867556622169,-10788
"AL","Limestone","01083",9809,25263,0.279681797445255,-15454
"AL","Lowndes","01085",5747,1754,0.76616451139848,3993
"AL","Macon","01087",9045,1322,0.872479984566413,7723
"AL","Madison","01089",61802,90679,0.405309513972233,-28877
"AL","Marengo","01091",6154,5321,0.536296296296296,833
"AL","Marion","01093",2249,9696,0.188279614901632,-7447
"AL","Marshall","01095",6271,25785,0.195626403793362,-19514
"AL","Mobile","01097",78417,94566,0.453322002740154,-16149
"AL","Monroe","01099",4897,5730,0.460807377434836,-833
"AL","Montgomery","01101",62993,38283,0.621993364666851,24710
"AL","Morgan","01103",13401,35309,0.275118045575857,-21908
"AL","Perry","01105",4536,1504,0.750993377483444,3032
"AL","Pickens","01107",4448,5119,0.464931535486568,-671
"AL","Pike","01109",6009,7939,0.430814453685116,-1930
"AL","Randolph","01111",3076,7219,0.298785818358426,-4143
"AL","Russell","01113",10495,8276,0.559107133343988,2219
"AL","Shelby","01117",19944,71243,0.218715387061752,-51299
"AL","St. Clair","01115",5790,29001,0.166422350607916,-23211
"AL","Sumter","01119",5420,1585,0.773733047822984,3835
"AL","Talladega","01121",13878,19217,0.419338268620638,-5339
"AL","Tallapoosa","01123",6252,12303,0.336944219886823,-6051
"AL","Tuscaloosa","01125",32003,45703,0.411847219004967,-13700
"AL","Walker","01127",6551,21633,0.232436843599205,-15082
"AL","Washington","01129",2971,5749,0.340711009174312,-2778
"AL","Wilcox","01131",4867,1676,0.743848387589791,3191
"AL","Winston","01133",1286,8310,0.134014172571905,-7024
"AR","Arkansas","05001",2454,3892,0.38670028364324,-1438
"AR","Ashley","05003",2855,4866,0.369770755083538,-2011
"AR","Baxter","05005",5172,13688,0.27423117709438,-8516
"AR","Benton","05007",22592,54544,0.292885293507571,-31952
"AR","Boone","05009",3762,11143,0.25239852398524,-7381
"AR","Bradley","05011",1447,2118,0.405890603085554,-671
"AR","Calhoun","05013",660,1458,0.311614730878187,-798
"AR","Carroll","05015",3691,6121,0.376172034243783,-2430
"AR","Chicot","05017",2649,1670,0.613336420467701,979
"AR","Clark","05019",3808,4343,0.467181940866151,-535
"AR","Clay","05021",1738,3225,0.350191416481967,-1487
"AR","Cleburne","05023",2618,8691,0.231497037757538,-6073
"AR","Cleveland","05025",845,2313,0.267574414186194,-1468
"AR","Columbia","05027",3557,5790,0.380549909061731,-2233
"AR","Conway","05029",3003,4511,0.399653979238754,-1508
"AR","Craighead","05031",10351,20044,0.340549432472446,-9693
"AR","Crawford","05033",4872,15125,0.243636545481822,-10253
"AR","Crittenden","05035",9092,6192,0.594870452761057,2900
"AR","Cross","05037",2279,4268,0.348098365663663,-1989
"AR","Dallas","05039",1337,1664,0.445518160613129,-327
"AR","Desha","05041",2353,1807,0.565625,546
"AR","Drew","05043",2627,3883,0.403533026113671,-1256
"AR","Faulkner","05045",13559,26653,0.337187904108226,-13094
"AR","Franklin","05047",1725,4631,0.271397105097546,-2906
"AR","Fulton","05049",1452,2949,0.329925017041581,-1497
"AR","Garland","05051",13317,25031,0.347267132575362,-11714
"AR","Grant","05053",1467,4829,0.233005082592122,-3362
"AR","Greene","05055",3998,9066,0.306031843233313,-5068
"AR","Hempstead","05057",2466,4284,0.365333333333333,-1818
"AR","Hot Spring","05059",3824,7087,0.350472000733205,-3263
"AR","Howard","05061",1460,2862,0.33780657103193,-1402
"AR","Independence","05063",3279,8724,0.273181704573857,-5445
"AR","Izard","05065",1563,3571,0.30444098169069,-2008
"AR","Jackson","05067",2093,3065,0.40577743311361,-972
"AR","Jefferson","05069",17456,9515,0.64721367394609,7941
"AR","Johnson","05071",2785,5045,0.355683269476373,-2260
"AR","Lafayette","05073",1173,1712,0.406585788561525,-539
"AR","Lawrence","05075",1786,3535,0.335651193384702,-1749
"AR","Lee","05077",2107,1280,0.622084440507824,827
"AR","Lincoln","05079",1424,2199,0.393044438310792,-775
"AR","Little River","05081",1552,3385,0.314360947944096,-1833
"AR","Logan","05083",2009,5078,0.28347678848596,-3069
"AR","Lonoke","05085",5612,17863,0.239062832800852,-12251
"AR","Madison","05087",2099,4262,0.329979562961798,-2163
"AR","Marion","05089",2024,4771,0.297866077998528,-2747
"AR","Miller","05091",4518,10622,0.298414795244386,-6104
"AR","Mississippi","05093",6445,6599,0.494096902790555,-154
"AR","Monroe","05095",1583,1585,0.499684343434343,-2
"AR","Montgomery","05097",920,2368,0.279805352798054,-1448
"AR","Nevada","05099",1314,1996,0.396978851963746,-682
"AR","Newton","05101",993,2508,0.28363324764353,-1515
"AR","Ouachita","05103",4626,5516,0.456123052652337,-890
"AR","Perry","05105",1187,2580,0.31510485797717,-1393
"AR","Phillips","05107",5179,2591,0.666537966537966,2588
"AR","Pike","05109",850,2847,0.229916148228293,-1997
"AR","Poinsett","05111",2387,4967,0.3245852597226,-2580
"AR","Polk","05113",1556,5950,0.207300826005862,-4394
"AR","Pope","05115",5108,14733,0.257446701275137,-9625
"AR","Prairie","05117",877,2149,0.289821546596167,-1272
"AR","Pulaski","05119",87055,68856,0.558363425287504,18199
"AR","Randolph","05121",2040,3699,0.355462624150549,-1659
"AR","Saint Francis","05123",4652,3287,0.585968006046102,1365
"AR","Saline","05125",12868,32962,0.280776783766092,-20094
"AR","Scott","05127",895,2630,0.253900709219858,-1735
"AR","Searcy","05129",814,2699,0.231710788499858,-1885
"AR","Sebastian","05131",13083,29158,0.309722781184158,-16075
"AR","Sevier","05133",1042,3135,0.249461335887,-2093
"AR","Sharp","05135",2092,4920,0.298345693097547,-2828
"AR","Stone","05137",1356,3773,0.264379021251706,-2417
"AR","Union","05139",6182,10696,0.366275625074061,-4514
"AR","Van Buren","05141",1826,4362,0.295087265675501,-2536
"AR","Washington","05143",28136,39570,0.415561397808171,-11434
"AR","White","05145",5765,20005,0.223709740007761,-14240
"AR","Woodruff","05147",1340,1227,0.522010128554733,113
"AR","Yell","05149",1720,4041,0.298559277903142,-2321
"AZ","Apache","04001",17144,8250,0.675120107111916,8894
"AZ","Cochise","04003",16223,26742,0.377586407541022,-10519
"AZ","Coconino","04005",26316,19368,0.576044129235619,6948
"AZ","Gila","04007",7293,12846,0.362133174437658,-5553
"AZ","Graham","04009",3608,8076,0.308798356727148,-4468
"AZ","Greenlee","04011",1310,1590,0.451724137931034,-280
"AZ","La Paz","04012",1619,3205,0.3356135986733,-1586
"AZ","Maricopa","04013",512008,654835,0.438797678865109,-142827
"AZ","Mohave","04015",18324,46442,0.282926226723898,-28118
"AZ","Navajo","04017",16157,19155,0.457549841413684,-2998
"AZ","Pima","04019",183470,162927,0.52965239306345,20543
"AZ","Pinal","04021",41428,58947,0.412732254047323,-17519
"AZ","Santa Cruz","04023",9486,4235,0.691349027038846,5251
"AZ","Yavapai","04025",32624,62385,0.343377995768822,-29761
"AZ","Yuma","04027",14025,19500,0.41834451901566,-5475
"CA","Alameda","06001",454344,106324,0.810361925417538,348020
"CA","Alpine","06003",389,236,0.6224,153
"CA","Amador","06005",6001,8903,0.4026435856146,-2902
"CA","Butte","06007",32567,35312,0.479780197115455,-2745
"CA","Calaveras","06009",7404,10537,0.412686026419932,-3133
"CA","Colusa","06011",2248,3521,0.389668920090137,-1273
"CA","Contra Costa","06013",239198,116867,0.671781837585834,122331
"CA","Del Norte","06015",3396,4256,0.443805541035024,-860
"CA","El Dorado","06017",34033,49661,0.406636079049872,-15628
"CA","Fresno","06019",85862,91143,0.485082342306714,-5281
"CA","Glenn","06021",3276,5608,0.368752814047726,-2332
"CA","Humboldt","06023",27757,15653,0.639414881363741,12104
"CA","Imperial","06025",17464,9545,0.646599281720908,7919
"CA","Inyo","06027",2775,3541,0.439360354654845,-766
"CA","Kern","06029",80257,119065,0.402649983443875,-38808
"CA","Kings","06031",12282,17184,0.41681938505396,-4902
"CA","Lake","06033",9159,6474,0.585876031471886,2685
"CA","Lassen","06035",3044,7261,0.295390587093644,-4217
"CA","Los Angeles","06037",1781383,754974,0.702339221174306,1026409
"CA","Madera","06039",12698,18990,0.400719515273921,-6292
"CA","Marin","06041",73450,23347,0.758804508404186,50103
"CA","Mariposa","06043",3080,4434,0.409901517167953,-1354
"CA","Mendocino","06045",11869,5129,0.698258618661019,6740
"CA","Merced","06047",26128,23403,0.527508025277099,2725
"CA","Modoc","06049",1113,2779,0.285971223021583,-1666
"CA","Mono","06051",2574,2202,0.53894472361809,372
"CA","Monterey","06053",51712,25087,0.673342100808604,26625
"CA","Napa","06055",19964,11647,0.631552307740976,8317
"CA","Nevada","06057",14261,15696,0.476049003571786,-1435
"CA","Orange","06059",457077,541592,0.457686180305987,-84515
"CA","Placer","06061",49126,74460,0.397504571715243,-25334
"CA","Plumas","06063",3670,5240,0.411896745230079,-1570
"CA","Riverside","06065",287754,290227,0.497860656319152,-2473
"CA","Sacramento","06067",251365,177523,0.586085411575983,73842
"CA","San Benito","06069",8617,6052,0.58742927261572,2565
"CA","San Bernardino","06071",274203,245468,0.5276472999263,28735
"CA","San Diego","06073",502937,453166,0.526028053462859,49771
"CA","San Francisco","06075",281226,44877,0.862383970708641,236349
"CA","San Joaquin","06077",98746,78794,0.556190154331418,19952
"CA","San Luis Obispo","06079",57655,56500,0.505058911129604,1155
"CA","San Mateo","06081",151036,56244,0.728656889231957,94792
"CA","Santa Barbara","06083",84279,59096,0.587822144725371,25183
"CA","Santa Clara","06085",343239,136347,0.715698539990742,206892
"CA","Santa Cruz","06087",61106,17132,0.781027122370204,43974
"CA","Shasta","06089",24199,45158,0.348904941101835,-20959
"CA","Sierra","06091",652,1056,0.381733021077283,-404
"CA","Siskiyou","06093",7110,9844,0.419370060162793,-2734
"CA","Solano","06095",87225,48364,0.643304397849383,38861
"CA","Sonoma","06097",124504,45666,0.731644825762473,78838
"CA","Stanislaus","06099",70609,69549,0.503781446653063,1060
"CA","Sutter","06101",8004,12576,0.388921282798834,-4572
"CA","Tehama","06103",6032,10791,0.358556737799441,-4759
"CA","Trinity","06105",2367,2422,0.494257673835874,-55
"CA","Tulare","06107",29191,42186,0.40896927581714,-12995
"CA","Tuolumne","06109",9628,13410,0.417918222067888,-3782
"CA","Ventura","06111",148006,131782,0.528993380702532,16224
"CA","Yolo","06113",38856,19080,0.670671085335543,19776
"CA","Yuba","06115",5817,8746,0.399436929204147,-2929
"CO","Adams","08001",90843,66531,0.577242746578215,24312
"CO","Alamosa","08003",3782,2693,0.584092664092664,1089
"CO","Arapahoe","08005",135433,114232,0.542458894919192,21201
"CO","Archuleta","08007",2637,3831,0.407699443413729,-1194
"CO","Baca","08009",462,1554,0.229166666666667,-1092
"CO","Bent","08011",778,1053,0.424904423812125,-275
"CO","Boulder","08013",120485,48526,0.712882593440664,71959
"CO","Broomfield","08014",16653,14765,0.530046470176332,1888
"CO","Chaffee","08015",4967,4949,0.500907624041952,18
"CO","Cheyenne","08017",162,858,0.158823529411765,-696
"CO","Clear Creek","08019",3041,2381,0.560863150129104,660
"CO","Conejos","08021",2180,1794,0.548565676899849,386
"CO","Costilla","08023",1317,440,0.749573136027319,877
"CO","Crowley","08025",535,924,0.366689513365319,-389
"CO","Custer","08027",862,1776,0.326762699014405,-914
"CO","Delta","08029",4542,10762,0.29678515420805,-6220
"CO","Denver","08031",209759,69755,0.750441838333679,140004
"CO","Dolores","08033",329,838,0.281919451585261,-509
"CO","Douglas","08035",54093,93930,0.365436452443201,-39837
"CO","Eagle","08037",12598,9317,0.574857403604837,3281
"CO","El Paso","08041",104989,163819,0.390572453200798,-58830
"CO","Elbert","08039",3542,10148,0.25872899926954,-6606
"CO","Fremont","08043",6644,13087,0.336729005118849,-6443
"CO","Garfield","08045",10989,12159,0.474727838258165,-1170
"CO","Gilpin","08047",1854,1320,0.584120982986768,534
"CO","Grand","08049",3575,4149,0.462843086483687,-574
"CO","Gunnison","08051",4563,3106,0.594992828269657,1457
"CO","Hinsdale","08053",228,352,0.393103448275862,-124
"CO","Huerfano","08055",1897,1615,0.540148063781321,282
"CO","Jackson","08057",216,600,0.264705882352941,-384
"CO","Jefferson","08059",153069,139960,0.522368093260394,13109
"CO","Kiowa","08061",118,677,0.148427672955975,-559
"CO","Kit Carson","08063",789,2664,0.228496959165943,-1875
"CO","La Plata","08067",15063,12554,0.545424919433682,2509
"CO","Lake","08065",1807,1087,0.624395300621976,720
"CO","Larimer","08069",83103,74603,0.526948879560702,8500
"CO","Las Animas","08071",3282,3105,0.513856270549554,177
"CO","Lincoln","08073",537,1663,0.244090909090909,-1126
"CO","Logan","08075",2675,6124,0.304011819524946,-3449
"CO","Mesa","08077",22448,45087,0.332390612275117,-22639
"CO","Mineral","08079",291,344,0.458267716535433,-53
"CO","Moffat","08081",1291,4616,0.218554257660403,-3325
"CO","Montezuma","08083",4486,7372,0.378310001686625,-2886
"CO","Montrose","08085",5852,12789,0.313931656027037,-6937
"CO","Morgan","08087",3761,6461,0.367931911563295,-2700
"CO","Otero","08089",3566,4315,0.452480649663748,-749
"CO","Ouray","08091",1640,1470,0.527331189710611,170
"CO","Park","08093",3721,5085,0.422552804905746,-1364
"CO","Phillips","08095",588,1637,0.264269662921348,-1049
"CO","Pitkin","08097",6648,2941,0.693294399833142,3707
"CO","Prowers","08099",1498,3200,0.318859088974031,-1702
"CO","Pueblo","08101",40624,31023,0.567002107555097,9601
"CO","Rio Blanco","08103",561,2677,0.17325509573811,-2116
"CO","Rio Grande","08105",2428,2892,0.456390977443609,-464
"CO","Routt","08107",7389,5361,0.579529411764706,2028
"CO","Saguache","08109",1762,937,0.652834383104854,825
"CO","San Juan","08111",266,212,0.556485355648536,54
"CO","San Miguel","08113",2961,1144,0.721315468940317,1817
"CO","Sedgwick","08115",419,881,0.322307692307692,-462
"CO","Summit","08117",9169,5495,0.625272776868522,3674
"CO","Teller","08119",3894,7909,0.329916123019571,-4015
"CO","Washington","08121",461,2059,0.182936507936508,-1598
"CO","Weld","08123",47418,62350,0.431983820421252,-14932
"CO","Yuma","08125",950,3433,0.216746520647958,-2483
"CT","Andover","90900001",904,724,0.555282555282555,180
"CT","Ansonia","90900002",4273,2596,0.62207017033047,1677
"CT","Ashford","90900003",1331,803,0.623711340206186,528
"CT","Avon","90900004",6305,5537,0.532426954906266,768
"CT","Barkhamsted","90900005",1033,1033,0.5,0
"CT","Beacon Falls","90900006",1300,1598,0.448585231193927,-298
"CT","Berlin","90900007",5499,5361,0.506353591160221,138
"CT","Bethany","90900008",1615,1536,0.512535702951444,79
"CT","Bethel","90900009",4777,4445,0.518000433745392,332
"CT","Bethlehem","90900010",894,1272,0.412742382271468,-378
"CT","Bloomfield","90900011",9917,1925,0.837442999493329,7992
"CT","Bolton","90900012",1433,1434,0.499825601674224,-1
"CT","Bozrah","90900013",648,606,0.516746411483254,42
"CT","Branford","90900014",8301,5817,0.587972800679983,2484
"CT","Bridgeport","90900015",32135,5168,0.861458863898346,26967
"CT","Bridgewater","90900016",529,641,0.452136752136752,-112
"CT","Bristol","90900017",13283,10548,0.557383240317234,2735
"CT","Brookfield","90900018",3916,4941,0.442136163486508,-1025
"CT","Brooklyn","90900019",1743,1570,0.526109266525807,173
"CT","Burlington","90900020",2357,2683,0.46765873015873,-326
"CT","Canaan","90900021",384,210,0.646464646464647,174
"CT","Canterbury","90900022",1197,1294,0.480529907667603,-97
"CT","Canton","90900023",2967,2742,0.519705727798213,225
"CT","Chaplin","90900024",584,466,0.556190476190476,118
"CT","Cheshire","90900025",7355,7271,0.502871598523178,84
"CT","Chester","90900026",1380,707,0.661236224245328,673
"CT","Clinton","90900027",3607,2926,0.552120006122761,681
"CT","Colchester","90900028",4125,3579,0.535436137071651,546
"CT","Colebrook","90900029",380,462,0.451306413301663,-82
"CT","Columbia","90900030",1714,1316,0.565676567656766,398
"CT","Cornwall","90900031",629,250,0.715585893060296,379
"CT","Coventry","90900032",3538,2621,0.574443903231044,917
"CT","Cromwell","90900033",4063,3193,0.559950385887541,870
"CT","Danbury","90900034",15290,10590,0.59080370942813,4700
"CT","Darien","90900035",3182,6220,0.338438630078707,-3038
"CT","Deep River","90900036",1479,932,0.613438407299876,547
"CT","Derby","90900037",2597,2032,0.561028299848779,565
"CT","Durham","90900038",2013,1985,0.503501750875438,28
"CT","East Granby","90900040",1389,1448,0.489601691928093,-59
"CT","East Haddam","90900041",2471,2109,0.539519650655022,362
"CT","East Hampton","90900042",3509,3138,0.52790732661351,371
"CT","East Hartford","90900043",13000,4272,0.752663270032422,8728
"CT","East Haven","90900044",6533,4650,0.584190288831262,1883
"CT","East Lyme","90900045",4808,3450,0.58222329861952,1358
"CT","East Windsor","90900047",3072,2250,0.577226606538895,822
"CT","Eastford","90900039",464,465,0.4994617868676,-1
"CT","Easton","90900046",1841,2380,0.436152570480929,-539
"CT","Ellington","90900048",3598,3894,0.480245595301655,-296
"CT","Enfield","90900049",10145,7703,0.56841102644554,2442
"CT","Essex","90900050",2230,1701,0.567285677944543,529
"CT","Fairfield","90900051",15282,14352,0.515691435513262,930
"CT","Farmington","90900052",7012,6610,0.514755542504772,402
"CT","Franklin","90900053",519,516,0.501449275362319,3
"CT","Glastonbury","90900054",10135,8809,0.534997888513513,1326
"CT","Goshen","90900055",749,1017,0.424122310305776,-268
"CT","Granby","90900056",3079,3221,0.488730158730159,-142
"CT","Greenwich","90900057",11137,14368,0.436659478533621,-3231
"CT","Griswold","90900058",2581,2166,0.54371181799031,415
"CT","Groton","90900059",8384,5367,0.609701112646353,3017
"CT","Guilford","90900060",7411,5170,0.589062872585645,2241
"CT","Haddam","90900061",2346,2230,0.512674825174825,116
"CT","Hamden","90900062",19181,7482,0.719386415632149,11699
"CT","Hampton","90900063",601,413,0.592702169625247,188
"CT","Hartford","90900064",31735,2138,0.936881882325156,29597
"CT","Hartland","90900065",414,778,0.347315436241611,-364
"CT","Harwinton","90900066",1260,1924,0.39572864321608,-664
"CT","Hebron","90900067",2606,2471,0.513295253102226,135
"CT","Kent","90900068",1080,606,0.640569395017794,474
"CT","Killingly","90900069",3255,2653,0.550947867298578,602
"CT","Killingworth","90900070",1921,1840,0.510768412656208,81
"CT","Lebanon","90900071",1878,1685,0.52708391804659,193
"CT","Ledyard","90900072",3564,3209,0.526206998375904,355
"CT","Lisbon","90900073",1125,890,0.558312655086849,235
"CT","Litchfield","90900074",2151,2403,0.472332015810277,-252
"CT","Lyme","90900075",856,593,0.590752242926156,263
"CT","Madison","90900076",5293,5193,0.504768262445165,100
"CT","Manchester","90900077",15565,7961,0.661608433222817,7604
"CT","Mansfield","90900078",6941,2193,0.759908035909788,4748
"CT","Marlborough","90900079",1791,1668,0.517779705117086,123
"CT","Meriden","90900080",14886,6880,0.68391068639162,8006
"CT","Middlebury","90900081",1675,2865,0.368942731277533,-1190
"CT","Middlefield","90900082",1334,1168,0.533173461231015,166
"CT","Middletown","90900083",13830,6105,0.693754702784048,7725
"CT","Milford","90900084",13668,11461,0.543913406820805,2207
"CT","Monroe","90900085",4446,5757,0.435754189944134,-1311
"CT","Montville","90900086",4014,3115,0.563052321503717,899
"CT","Morris","90900087",542,747,0.420480993017843,-205
"CT","Naugatuck","90900088",5923,5807,0.504944586530264,116
"CT","New Britain","90900089",16051,4782,0.770460327365238,11269
"CT","New Canaan","90900090",3804,6966,0.353203342618384,-3162
"CT","New Fairfield","90900091",3323,4288,0.43660491394035,-965
"CT","New Hartford","90900092",1759,2056,0.461074705111402,-297
"CT","New Haven","90900093",39865,4430,0.899988712044249,35435
"CT","New London","90900095",6710,1654,0.802247728359637,5056
"CT","New Milford","90900096",6640,6330,0.51195065535852,310
"CT","Newington","90900094",8792,5752,0.604510451045104,3040
"CT","Newtown","90900097",6822,7591,0.473322694789426,-769
"CT","Norfolk","90900098",556,384,0.591489361702128,172
"CT","North Branford","90900099",3375,3290,0.506376594148537,85
"CT","North Canaan","90900100",706,552,0.56120826709062,154
"CT","North Haven","90900101",6376,5990,0.515607310367136,386
"CT","North Stonington","90900102",1383,1279,0.519534184823441,104
"CT","Norwalk","90900103",22369,12773,0.636531785328097,9596
"CT","Norwich","90900104",8542,4144,0.673340690524988,4398
"CT","Old Lyme","90900105",2561,1958,0.566718300508962,603
"CT","Old Saybrook","90900106",3101,2753,0.529723266142808,348
"CT","Orange","90900107",3607,4206,0.461666453346986,-599
"CT","Oxford","90900108",2599,3905,0.39960024600246,-1306
"CT","Plainfield","90900109",2957,2378,0.554264292408622,579
"CT","Plainville","90900110",4545,3320,0.57787666878576,1225
"CT","Plymouth","90900111",2553,2713,0.484808203570072,-160
"CT","Pomfret","90900112",1103,1012,0.521513002364066,91
"CT","Portland","90900113",2664,2141,0.554422476586889,523
"CT","Preston","90900114",1165,1186,0.495533815397703,-21
"CT","Prospect","90900115",1839,3235,0.362435947970043,-1396
"CT","Putnam","90900116",1839,1507,0.549611476389719,332
"CT","Redding","90900117",2787,2503,0.526843100189036,284
"CT","Ridgefield","90900118",6461,7360,0.467477027711454,-899
"CT","Rocky Hill","90900119",5173,4029,0.562160399913062,1144
"CT","Roxbury","90900120",758,706,0.51775956284153,52
"CT","Salem","90900121",1098,996,0.524355300859599,102
"CT","Salisbury","90900122",1552,659,0.701944821347806,893
"CT","Scotland","90900123",408,415,0.495747266099635,-7
"CT","Seymour","90900124",3447,3630,0.487070792708775,-183
"CT","Sharon","90900125",902,519,0.634764250527797,383
"CT","Shelton","90900126",8362,10327,0.447428968912194,-1965
"CT","Sherman","90900127",1020,1049,0.492991783470276,-29
"CT","Simsbury","90900128",6853,6710,0.505271695052717,143
"CT","Somers","90900129",2055,2837,0.420073589533933,-782
"CT","South Windsor","90900132",7708,5774,0.571725263314048,1934
"CT","Southbury","90900130",4424,5626,0.440199004975124,-1202
"CT","Southington","90900131",10727,10452,0.506492280088767,275
"CT","Sprague","90900133",724,655,0.525018129079043,69
"CT","Stafford","90900134",3018,2491,0.547830822290797,527
"CT","Stamford","90900135",29623,17473,0.628991846441311,12150
"CT","Sterling","90900136",655,711,0.479502196193265,-56
"CT","Stonington","90900137",5642,3884,0.592273777031283,1758
"CT","Stratford","90900138",13483,9324,0.591178147060113,4159
"CT","Suffield","90900139",3332,3863,0.463099374565671,-531
"CT","Thomaston","90900140",1556,2144,0.420540540540541,-588
"CT","Thompson","90900141",1977,1993,0.497984886649874,-16
"CT","Tolland","90900142",4135,3840,0.518495297805643,295
"CT","Torrington","90900143",6843,7320,0.483160347384029,-477
"CT","Trumbull","90900144",8703,9986,0.465674995986944,-1283
"CT","Union","90900145",257,250,0.506903353057199,7
"CT","Vernon","90900146",7546,5079,0.59770297029703,2467
"CT","Voluntown","90900147",610,600,0.504132231404959,10
"CT","Wallingford","90900148",11559,9259,0.555240657123643,2300
"CT","Warren","90900149",404,407,0.498150431565968,-3
"CT","Washington","90900150",1237,824,0.600194080543425,413
"CT","Waterbury","90900151",32495,11043,0.746359502044191,21452
"CT","Waterford","90900152",5573,4183,0.571238212382124,1390
"CT","Watertown","90900153",4091,6581,0.383339580209895,-2490
"CT","West Hartford","90900155",21080,10538,0.666708836738567,10542
"CT","West Haven","90900156",14286,5789,0.711631382316314,8497
"CT","Westbrook","90900154",1903,1605,0.542474344355758,298
"CT","Weston","90900157",2911,2514,0.536589861751152,397
"CT","Westport","90900158",8494,6439,0.568807339449541,2055
"CT","Wethersfield","90900159",7753,6015,0.563117373619988,1738
"CT","Willington","90900160",1538,1241,0.553436487945304,297
"CT","Wilton","90900161",4589,5424,0.458304204534106,-835
"CT","Winchester","90900162",2201,2389,0.479520697167756,-188
"CT","Windham","90900163",5818,1944,0.749549085287297,3874
"CT","Windsor","90900164",11461,4305,0.726944056831156,7156
"CT","Windsor Locks","90900165",3174,2454,0.563965884861407,720
"CT","Wolcott","90900166",3139,5077,0.382059396299903,-1938
"CT","Woodbridge","90900167",3018,2104,0.589222959781335,914
"CT","Woodbury","90900168",2434,3058,0.443190094683176,-624
"CT","Woodstock","90900169",2021,2134,0.486401925391095,-113
"DC","District of Columbia","11001",222332,17337,0.927662734855154,204995
"DE","Kent","10001",35525,32134,0.52505948949881,3391
"DE","New Castle","10003",167051,81226,0.672841221699956,85825
"DE","Sussex","10005",39971,52116,0.434056924430158,-12145
"FL","Alachua","12001",69634,48765,0.588129967313913,20869
"FL","Baker","12003",2310,8974,0.204714640198511,-6664
"FL","Bay","12005",22037,56863,0.279302915082383,-34826
"FL","Bradford","12007",3324,8216,0.288041594454073,-4892
"FL","Brevard","12009",122972,159270,0.435697025956449,-36298
"FL","Broward","12011",507430,243732,0.675526717272706,263698
"FL","Calhoun","12013",1664,4366,0.275953565505804,-2702
"FL","Charlotte","12015",35896,47988,0.42792427638167,-12092
"FL","Citrus","12017",28453,44657,0.389180686636575,-16204
"FL","Clay","12019",25745,69996,0.268902560031752,-44251
"FL","Collier","12021",51678,96508,0.348737397594915,-44830
"FL","Columbia","12023",8462,18429,0.31467777323268,-9967
"FL","DeSoto","12027",4174,5587,0.427620120889253,-1413
"FL","Dixie","12029",1798,5052,0.262481751824818,-3254
"FL","Duval","12031",196657,211553,0.481754489110997,-14896
"FL","Escambia","12033",58154,88671,0.396076962370169,-30517
"FL","Flagler","12035",23204,26966,0.462507474586406,-3762
"FL","Franklin","12037",1845,3570,0.340720221606648,-1725
"FL","Gadsden","12039",15768,6628,0.704054295409895,9140
"FL","Gilchrist","12041",1885,5917,0.241604716739298,-4032
"FL","Glades","12043",1603,2344,0.406131238915632,-741
"FL","Gulf","12045",2013,4995,0.287243150684932,-2982
"FL","Hamilton","12047",2226,3137,0.415066194294238,-911
"FL","Hardee","12049",2461,4694,0.343955276030748,-2233
"FL","Hendry","12051",4751,5355,0.470116762319414,-604
"FL","Hernando","12053",37791,44906,0.456981510816596,-7115
"FL","Highlands","12055",16147,25912,0.383913074490597,-9765
"FL","Hillsborough","12057",286158,249904,0.533815118400484,36254
"FL","Holmes","12059",1264,6919,0.154466577049982,-5655
"FL","Indian River","12061",27483,43441,0.387499295020021,-15958
"FL","Jackson","12063",7342,13417,0.353677922828653,-6075
"FL","Jefferson","12065",3945,3808,0.50883528956533,137
"FL","Lafayette","12067",687,2668,0.204769001490313,-1981
"FL","Lake","12069",61790,87637,0.413512952813079,-25847
"FL","Lee","12071",110080,154112,0.416666666666667,-44032
"FL","Leon","12073",90863,55806,0.619510598695021,35057
"FL","Levy","12075",6118,12052,0.336708860759494,-5934
"FL","Liberty","12077",942,2301,0.290471785383904,-1359
"FL","Madison","12079",4174,4474,0.482654949121184,-300
"FL","Manatee","12081",66476,85616,0.437077558319964,-19140
"FL","Marion","12083",66823,93036,0.418012123183556,-26213
"FL","Martin","12085",30097,48180,0.38449352938922,-18083
"FL","Miami-Dade","12086",540776,332602,0.619177492448859,208174
"FL","Monroe","12087",19392,19234,0.502045254491793,158
"FL","Nassau","12089",10249,29926,0.255108898568762,-19677
"FL","Okaloosa","12091",23390,70143,0.250072167042648,-46753
"FL","Okeechobee","12093",4856,7325,0.398653640916181,-2469
"FL","Orange","12095",274227,189057,0.591919859092911,85170
"FL","Osceola","12097",67201,40581,0.623490007607949,26620
"FL","Palm Beach","12099",349418,247257,0.585608580885742,102161
"FL","Pasco","12101",98148,112335,0.466298941007112,-14187
"FL","Pinellas","12103",238966,213192,0.528501099173298,25774
"FL","Polk","12105",114610,131566,0.465561224489796,-16956
"FL","Putnam","12107",11666,19326,0.376419721218379,-7660
"FL","Santa Rosa","12113",17757,58169,0.233872454758581,-40412
"FL","Sarasota","12115",95089,110489,0.462544630261993,-15400
"FL","Seminole","12117",96435,109939,0.467282700340159,-13504
"FL","St. Johns","12109",35155,78490,0.309340490122751,-43335
"FL","St. Lucie","12111",65869,56202,0.539595808996404,9667
"FL","Sumter","12119",19519,40644,0.32443528414474,-21125
"FL","Suwannee","12121",4749,12672,0.272602032030308,-7923
"FL","Taylor","12123",2761,6249,0.306437291897891,-3488
"FL","Union","12125",1339,3980,0.251739048693363,-2641
"FL","Volusia","12127",114716,117473,0.494063026241553,-2757
"FL","Wakulla","12129",5173,9288,0.357720766198741,-4115
"FL","Walton","12131",6665,21483,0.236784140969163,-14818
"FL","Washington","12133",2820,8037,0.25974025974026,-5217
"GA","Appling","13001",1756,5231,0.251323887219121,-3475
"GA","Atkinson","13003",930,1938,0.324267782426778,-1008
"GA","Bacon","13005",791,3092,0.203708472830286,-2301
"GA","Baker","13007",790,784,0.501905972045743,6
"GA","Baldwin","13009",8469,7585,0.52753207923259,884
"GA","Banks","13011",779,5353,0.127038486627528,-4574
"GA","Barrow","13013",6019,18719,0.243309887622282,-12700
"GA","Bartow","13015",8383,26847,0.237950610275334,-18464
"GA","Ben Hill","13017",2508,3395,0.424868710825004,-887
"GA","Berrien","13019",1268,4837,0.207698607698608,-3569
"GA","Bibb","13021",38538,25606,0.600804440009978,12932
"GA","Bleckley","13023",1266,3586,0.260923330585326,-2320
"GA","Brantley","13025",939,4963,0.159098610640461,-4024
"GA","Brooks","13027",3101,3522,0.468216820172127,-421
"GA","Bryan","13029",3695,9537,0.279247279322854,-5842
"GA","Bulloch","13031",9572,14159,0.403354262357254,-4587
"GA","Burke","13033",5403,4298,0.556952891454489,1105
"GA","Butts","13035",2966,6306,0.319887834339948,-3340
"GA","Calhoun","13037",1297,883,0.594954128440367,414
"GA","Camden","13039",6358,11318,0.35969676397375,-4960
"GA","Candler","13043",1155,2344,0.33009431266076,-1189
"GA","Carroll","13045",12635,28249,0.309045103218863,-15614
"GA","Catoosa","13047",5357,17848,0.230855419090713,-12491
"GA","Charlton","13049",1197,2527,0.321428571428571,-1330
"GA","Chatham","13051",60077,47083,0.560628966032102,12994
"GA","Chattahoochee","13053",726,732,0.497942386831276,-6
"GA","Chattooga","13055",2220,5434,0.290044421217664,-3214
"GA","Cherokee","13057",19813,76473,0.205772386432088,-56660
"GA","Clarke","13059",25386,13804,0.647767287573361,11582
"GA","Clay","13061",862,537,0.616154395997141,325
"GA","Clayton","13063",81439,14158,0.851899118173164,67281
"GA","Clinch","13065",852,1598,0.347755102040816,-746
"GA","Cobb","13067",132526,171464,0.435955130102964,-38938
"GA","Coffee","13069",5048,9242,0.353254023792862,-4194
"GA","Colquitt","13071",3971,9240,0.300582847626978,-5269
"GA","Columbia","13073",16420,41724,0.282402311502477,-25304
"GA","Cook","13075",2042,3934,0.341700133868809,-1892
"GA","Coweta","13077",15156,39633,0.276624869955648,-24477
"GA","Crawford","13079",1699,3366,0.335439289239882,-1667
"GA","Crisp","13081",3160,4179,0.430576372802834,-1019
"GA","Dade","13083",1404,4458,0.239508700102354,-3054
"GA","Dawson","13085",1241,8843,0.123066243554145,-7602
"GA","Decatur","13087",4580,5816,0.440554059253559,-1236
"GA","DeKalb","13089",237704,64308,0.787068063520655,173396
"GA","Dodge","13091",2440,5214,0.318787562059054,-2774
"GA","Dooly","13093",2278,1983,0.534616287256513,295
"GA","Dougherty","13095",26209,11441,0.696122177954847,14768
"GA","Douglas","13097",28410,26226,0.519986821875686,2184
"GA","Early","13099",2762,2556,0.519368183527642,206
"GA","Echols","13101",173,917,0.158715596330275,-744
"GA","Effingham","13103",4941,15591,0.240648743424898,-10650
"GA","Elbert","13105",3179,4857,0.395594823295172,-1678
"GA","Emanuel","13107",2919,5086,0.364647095565272,-2167
"GA","Evans","13109",1266,2267,0.358335692046419,-1001
"GA","Fannin","13111",2027,7853,0.205161943319838,-5826
"GA","Fayette","13113",19703,38046,0.341183397115102,-18343
"GA","Floyd","13115",9595,22636,0.297694765908597,-13041
"GA","Forsyth","13117",14544,65853,0.180902272472853,-51309
"GA","Franklin","13119",1499,6112,0.196951780317961,-4613
"GA","Fulton","13121",248479,133837,0.649930947174589,114642
"GA","Gilmer","13123",1955,8920,0.179770114942529,-6965
"GA","Glascock","13125",176,1135,0.134248665141114,-959
"GA","Glynn","13127",11922,20853,0.363752860411899,-8931
"GA","Gordon","13129",3436,13174,0.206863335340157,-9738
"GA","Grady","13131",3419,5922,0.36602076865432,-2503
"GA","Greene","13133",3195,5067,0.386710239651416,-1872
"GA","Gwinnett","13135",131879,159563,0.452505129665594,-27684
"GA","Habersham","13137",2297,12148,0.15901696088612,-9851
"GA","Hall","13139",12489,45918,0.213827109764241,-33429
"GA","Hancock","13141",3301,764,0.812054120541205,2537
"GA","Haralson","13143",1787,8439,0.174750635634657,-6652
"GA","Harris","13145",4141,11193,0.270053475935829,-7052
"GA","Hart","13147",2869,6516,0.305700586041556,-3647
"GA","Heard","13149",947,3155,0.230862993661628,-2208
"GA","Henry","13151",43374,46299,0.48369074303302,-2925
"GA","Houston","13153",22643,34631,0.395345182805461,-11988
"GA","Irwin","13155",1134,2519,0.310429783739392,-1385
"GA","Jackson","13157",4236,19122,0.181351143077318,-14886
"GA","Jasper","13159",1839,4121,0.308557046979866,-2282
"GA","Jeff Davis","13161",1271,3994,0.241405508072175,-2723
"GA","Jefferson","13163",4238,2992,0.586168741355463,1246
"GA","Jenkins","13165",1487,1884,0.441115396024918,-397
"GA","Johnson","13167",1305,2440,0.348464619492657,-1135
"GA","Jones","13169",4272,7740,0.355644355644356,-3468
"GA","Lamar","13171",2602,4896,0.347025873566284,-2294
"GA","Lanier","13173",1108,1812,0.379452054794521,-704
"GA","Laurens","13175",7508,11947,0.38591621691082,-4439
"GA","Lee","13177",3187,10310,0.236126546639994,-7123
"GA","Liberty","13179",10427,5558,0.652299030340945,4869
"GA","Lincoln","13181",1586,2806,0.361111111111111,-1220
"GA","Long","13183",1434,2300,0.384038564542046,-866
"GA","Lowndes","13185",17118,21176,0.447015198203374,-4058
"GA","Lumpkin","13187",2049,8633,0.191818011608313,-6584
"GA","Macon","13193",3211,1545,0.675147182506308,1666
"GA","Madison","13195",2486,8441,0.227509838015924,-5955
"GA","Marion","13197",1411,1731,0.449077021005729,-320
"GA","McDuffie","13189",4041,5475,0.424653215636822,-1434
"GA","McIntosh","13191",2860,3405,0.456504389465283,-545
"GA","Meriwether","13199",4328,4855,0.47130567352717,-527
"GA","Miller","13201",848,1904,0.308139534883721,-1056
"GA","Mitchell","13205",4081,4153,0.495627884381831,-72
"GA","Monroe","13207",3779,8352,0.311515950869673,-4573
"GA","Montgomery","13209",1135,2662,0.29892020015802,-1527
"GA","Morgan","13211",2751,6178,0.308097211333856,-3427
"GA","Murray","13213",2542,8439,0.231490756761679,-5897
"GA","Muscogee","13215",42458,27469,0.607176055028816,14989
"GA","Newton","13217",21844,20979,0.510099712771174,865
"GA","Oconee","13219",4140,12222,0.253025302530253,-8082
"GA","Oglethorpe","13221",1913,4250,0.310400778841473,-2337
"GA","Paulding","13223",15779,40771,0.279027409372237,-24992
"GA","Peach","13225",6141,5280,0.537693722090885,861
"GA","Pickens","13227",1975,10547,0.157722408560933,-8572
"GA","Pierce","13229",1124,5666,0.165537555228277,-4542
"GA","Pike","13231",1355,6660,0.169058016219588,-5305
"GA","Polk","13233",3608,9798,0.269133223929584,-6190
"GA","Pulaski","13235",1219,2444,0.332787332787333,-1225
"GA","Putnam","13237",2917,6210,0.31960118330229,-3293
"GA","Quitman","13239",612,510,0.545454545454545,102
"GA","Rabun","13241",1558,5753,0.21310354260703,-4195
"GA","Randolph","13243",1749,1249,0.583388925950634,500
"GA","Richmond","13245",52461,25821,0.670154058404231,26640
"GA","Rockdale","13247",21878,15671,0.582652001384857,6207
"GA","Schley","13249",448,1286,0.25836216839677,-838
"GA","Screven","13251",2769,3285,0.457383548067393,-516
"GA","Seminole","13253",1475,2244,0.396611992471094,-769
"GA","Spalding","13255",9884,14901,0.398789590478112,-5017
"GA","Stephens","13257",2123,7207,0.227545551982851,-5084
"GA","Stewart","13259",1307,740,0.638495359062042,567
"GA","Sumter","13261",6370,5372,0.542497019247147,998
"GA","Talbot","13263",2264,1202,0.653202538949798,1062
"GA","Taliaferro","13265",636,321,0.664576802507837,315
"GA","Tattnall","13267",1894,4702,0.287143723468769,-2808
"GA","Taylor","13269",1571,1948,0.446433645922137,-377
"GA","Telfair","13271",1804,2479,0.421200093392482,-675
"GA","Terrell","13273",2544,1834,0.581087254454089,710
"GA","Thomas","13275",7651,11153,0.406881514571368,-3502
"GA","Tift","13277",4640,9171,0.33596408659764,-4531
"GA","Toombs","13279",2740,6519,0.295928285992008,-3779
"GA","Towns","13281",1265,4834,0.207411050991966,-3569
"GA","Treutlen","13283",1068,1646,0.393515106853353,-578
"GA","Troup","13285",10545,15170,0.410071942446043,-4625
"GA","Turner","13287",1508,2027,0.426591230551627,-519
"GA","Twiggs","13289",2269,1905,0.543603258265453,364
"GA","Union","13291",2137,8771,0.195911257792446,-6634
"GA","Upson","13293",3955,7229,0.353630185979971,-3274
"GA","Walker","13295",5269,16245,0.24491029097332,-10976
"GA","Walton","13297",8139,29018,0.219043518045052,-20879
"GA","Ware","13299",3892,7933,0.329133192389006,-4041
"GA","Warren","13301",1525,990,0.606361829025845,535
"GA","Washington","13303",4705,4033,0.538452735179675,672
"GA","Wayne","13305",2594,7553,0.255642061693111,-4959
"GA","Webster","13307",573,598,0.48932536293766,-25
"GA","Wheeler","13309",772,1366,0.361085126286249,-594
"GA","White","13311",1670,8647,0.161868760298536,-6977
"GA","Whitfield","13313",7193,19290,0.271608201487747,-12097
"GA","Wilcox","13315",1059,2050,0.340623994853651,-991
"GA","Wilkes","13317",2080,2628,0.441801189464741,-548
"GA","Wilkinson","13319",2180,2245,0.492655367231638,-65
"GA","Worth","13321",2486,5864,0.297724550898204,-3378
"HI","Hawaii","15001",46670,14541,0.762444658639787,32129
"HI","Honolulu","15003",201803,87255,0.698140165641498,114548
"HI","Kauai","15007",18638,6121,0.752776768043944,12517
"HI","Maui","15009",35979,11577,0.756560686348726,24402
"IA","Adair","19001",1788,2110,0.458696767573114,-322
"IA","Adams","19003",1018,1103,0.47996228194248,-85
"IA","Allamakee","19005",3511,3230,0.520842604954755,281
"IA","Appanoose","19007",2934,3153,0.482010842779694,-219
"IA","Audubon","19009",1608,1800,0.471830985915493,-192
"IA","Benton","19011",6850,6935,0.496916938701487,-85
"IA","Black Hawk","19013",39338,26078,0.601351351351351,13260
"IA","Boone","19015",7457,6540,0.532757019361292,917
"IA","Bremer","19017",6710,6383,0.512487588787902,327
"IA","Buchanan","19019",5903,4443,0.570558670017398,1460
"IA","Buena Vista","19021",3683,4548,0.447454744259507,-865
"IA","Butler","19023",3321,4104,0.447272727272727,-783
"IA","Calhoun","19025",2232,2890,0.435767278406872,-658
"IA","Carroll","19027",4912,5577,0.468300123939365,-665
"IA","Cass","19029",2856,4212,0.404074702886248,-1356
"IA","Cedar","19031",4931,4510,0.522296366910285,421
"IA","Cerro Gordo","19033",13204,10084,0.566987289591206,3120
"IA","Cherokee","19035",2623,3656,0.417741678611244,-1033
"IA","Chickasaw","19037",3552,2836,0.556042579837195,716
"IA","Clarke","19039",2187,2124,0.507306889352818,63
"IA","Clay","19041",3363,4934,0.405327226708449,-1571
"IA","Clayton","19043",4768,4146,0.534888938748037,622
"IA","Clinton","19045",15123,9423,0.616108530921535,5700
"IA","Crawford","19047",3035,3584,0.458528478622148,-549
"IA","Dallas","19049",16466,20921,0.440420467007249,-4455
"IA","Davis","19051",1518,2133,0.415776499589154,-615
"IA","Decatur","19053",1790,1945,0.479250334672021,-155
"IA","Delaware","19055",4605,4628,0.498754467670313,-23
"IA","Des Moines","19057",11873,8130,0.593560965855122,3743
"IA","Dickinson","19059",4088,5911,0.408840884088409,-1823
"IA","Dubuque","19061",28600,21265,0.573548581169157,7335
"IA","Emmet","19063",2087,2499,0.455080680331443,-412
"IA","Fayette","19065",5709,4484,0.56009025802021,1225
"IA","Floyd","19067",4674,3466,0.574201474201474,1208
"IA","Franklin","19069",2256,2818,0.444619629483642,-562
"IA","Fremont","19071",1636,1971,0.453562517327419,-335
"IA","Greene","19073",2369,2373,0.499578237030789,-4
"IA","Grundy","19075",2615,4205,0.383431085043988,-1590
"IA","Guthrie","19077",2565,3164,0.447722115552452,-599
"IA","Hamilton","19079",3776,3986,0.486472558618913,-210
"IA","Hancock","19081",2506,3306,0.431176875430145,-800
"IA","Hardin","19083",4021,4647,0.463890170742963,-626
"IA","Harrison","19085",3131,4059,0.435465924895688,-928
"IA","Henry","19087",4451,5025,0.469712959054453,-574
"IA","Howard","19089",2767,1793,0.606798245614035,974
"IA","Humboldt","19091",1967,3099,0.388274772996447,-1132
"IA","Ida","19093",1317,2276,0.366546061786808,-959
"IA","Iowa","19095",4118,4551,0.475025954550698,-433
"IA","Jackson","19097",5877,4171,0.584892515923567,1706
"IA","Jasper","19099",10240,8868,0.535901193217501,1372
"IA","Jefferson","19101",4772,3429,0.58188025850506,1343
"IA","Johnson","19103",50090,23556,0.680145561198164,26534
"IA","Jones","19105",5514,4712,0.539213768824565,802
"IA","Keokuk","19107",2298,2840,0.447255741533671,-542
"IA","Kossuth","19109",3824,4914,0.437628747997253,-1090
"IA","Lee","19111",9428,6787,0.581436941103916,2641
"IA","Linn","19113",68028,47427,0.589216577887489,20601
"IA","Louisa","19115",2449,2416,0.503391572456321,33
"IA","Lucas","19117",1977,2248,0.46792899408284,-271
"IA","Lyon","19119",1416,4965,0.221908791725435,-3549
"IA","Madison","19121",3508,4492,0.4385,-984
"IA","Mahaska","19123",4207,6420,0.395878422885104,-2213
"IA","Marion","19125",7478,9810,0.432554372975474,-2332
"IA","Marshall","19127",10085,8411,0.545253027681661,1674
"IA","Mills","19129",2842,4211,0.402949099673898,-1369
"IA","Mitchell","19131",2831,2643,0.517172086225795,188
"IA","Monona","19133",2098,2555,0.450891897700408,-457
"IA","Monroe","19135",1729,2022,0.460943748333778,-293
"IA","Montgomery","19137",1919,2999,0.39019926799512,-1080
"IA","Muscatine","19139",11213,8152,0.579034340304673,3061
"IA","O'Brien","19141",1964,5259,0.271909179011491,-3295
"IA","Osceola","19143",909,2225,0.290044671346522,-1316
"IA","Page","19145",2588,4338,0.373664452786601,-1750
"IA","Palo Alto","19147",2124,2649,0.445003142677561,-525
"IA","Plymouth","19149",4148,8577,0.325972495088409,-4429
"IA","Pocahontas","19151",1518,2388,0.38863287250384,-870
"IA","Polk","19153",128264,96029,0.571859130690659,32235
"IA","Pottawattamie","19155",19347,21751,0.470752834687819,-2404
"IA","Poweshiek","19157",5307,4409,0.546212433100041,898
"IA","Ringgold","19159",1181,1366,0.463682764036121,-185
"IA","Sac","19161",2117,3086,0.40688064578128,-969
"IA","Scott","19163",50581,38223,0.569580199090131,12358
"IA","Shelby","19165",2468,3903,0.387380317061686,-1435
"IA","Sioux","19167",2683,14361,0.157416099507158,-11678
"IA","Story","19169",25940,19557,0.570147482251577,6383
"IA","Tama","19171",4737,4076,0.537501418359242,661
"IA","Taylor","19173",1261,1680,0.428765725943557,-419
"IA","Union","19175",3029,2800,0.51964316349288,229
"IA","Van Buren","19177",1398,2058,0.404513888888889,-660
"IA","Wapello","19179",8616,6777,0.559734944455272,1839
"IA","Warren","19181",12521,13031,0.490020350657483,-510
"IA","Washington","19183",5081,5540,0.478391865172771,-459
"IA","Wayne","19185",1251,1583,0.441425546930134,-332
"IA","Webster","19187",9458,8453,0.528055384958964,1005
"IA","Winnebago","19189",2895,2897,0.499827348066298,-2
"IA","Winneshiek","19191",6245,4618,0.57488723188806,1627
"IA","Woodbury","19193",22026,22136,0.498754585390154,-110
"IA","Worth","19195",2343,1743,0.573421439060206,600
"IA","Wright","19197",2794,3309,0.457807635589055,-515
"ID","Ada","16001",77043,97471,0.44147174438727,-20428
"ID","Adams","16003",577,1413,0.289949748743719,-836
"ID","Bannock","16005",13214,21010,0.386103319308088,-7796
"ID","Bear Lake","16007",302,2489,0.10820494446435,-2187
"ID","Benewah","16009",1164,2596,0.309574468085106,-1432
"ID","Bingham","16011",3822,13440,0.221411192214112,-9618
"ID","Blaine","16013",5992,3939,0.603363206122243,2053
"ID","Boise","16015",953,2284,0.294408402842138,-1331
"ID","Bonner","16017",6500,11367,0.363799182851066,-4867
"ID","Bonneville","16019",9929,32336,0.234922512717378,-22407
"ID","Boundary","16021",1225,3138,0.280770112308045,-1913
"ID","Butte","16023",258,1001,0.204924543288324,-743
"ID","Camas","16025",159,402,0.283422459893048,-243
"ID","Canyon","16027",19866,44369,0.309270646843621,-24503
"ID","Caribou","16029",385,2608,0.128633478115603,-2223
"ID","Cassia","16031",1093,7150,0.132597355331797,-6057
"ID","Clark","16033",66,235,0.219269102990033,-169
"ID","Clearwater","16035",1032,2541,0.288832913518052,-1509
"ID","Custer","16037",530,1744,0.233069481090589,-1214
"ID","Elmore","16039",2513,5227,0.324677002583979,-2714
"ID","Franklin","16041",325,5195,0.0588768115942029,-4870
"ID","Fremont","16043",810,4907,0.141682700717159,-4097
"ID","Gem","16045",1957,5311,0.269262520638415,-3354
"ID","Gooding","16047",1287,3696,0.258278145695364,-2409
"ID","Idaho County","16049",1722,5821,0.228291130849795,-4099
"ID","Jefferson","16051",1303,9895,0.116360064297196,-8592
"ID","Jerome","16053",1699,4804,0.261264031985238,-3105
"ID","Kootenai","16055",18824,39347,0.323597668941569,-20523
"ID","Latah","16057",8306,7589,0.52255426234665,717
"ID","Lemhi","16059",960,3029,0.240661820005014,-2069
"ID","Lewis","16061",396,1173,0.252390057361377,-777
"ID","Lincoln","16063",429,1141,0.273248407643312,-712
"ID","Madison","16065",832,13445,0.0582755480843314,-12613
"ID","Minidoka","16067",1390,5442,0.203454332552693,-4052
"ID","Nez Perce","16069",6451,9967,0.392922402241442,-3516
"ID","Oneida","16071",217,1838,0.105596107055961,-1621
"ID","Owyhee","16073",833,2794,0.229666390956714,-1961
"ID","Payette","16075",2271,6004,0.274441087613293,-3733
"ID","Power","16077",982,1870,0.344319775596073,-888
"ID","Shoshone","16079",2277,2699,0.457596463022508,-422
"ID","Teton","16081",1926,2458,0.439324817518248,-532
"ID","Twin Falls","16083",7541,19773,0.276085523907154,-12232
"ID","Valley","16085",2095,2664,0.440218533305316,-569
"ID","Washington","16087",1104,3128,0.260869565217391,-2024
"IL","Adams","17001",9627,20371,0.320921394759651,-10744
"IL","Alexander","17003",1961,1485,0.569065583284968,476
"IL","Bond","17005",3016,4091,0.424370339102293,-1075
"IL","Boone","17007",9868,11084,0.470981290568919,-1216
"IL","Brown","17009",787,1511,0.342471714534378,-724
"IL","Bureau","17011",8118,8151,0.498985801217039,-33
"IL","Calhoun","17013",1079,1439,0.428514694201747,-360
"IL","Carroll","17015",3658,3551,0.50742127895686,107
"IL","Cass","17017",2050,2707,0.430943872188354,-657
"IL","Champaign","17019",40378,35086,0.535063076433796,5292
"IL","Chicago","91700103",821523,142577,0.852113888600768,678946
"IL","Christian","17021",5487,8873,0.382103064066852,-3386
"IL","Clark","17023",2587,5138,0.334886731391586,-2551
"IL","Clay","17025",1581,4184,0.274241110147441,-2603
"IL","Clinton","17027",5577,10493,0.34704418170504,-4916
"IL","Coles","17029",9252,11623,0.443209580838323,-2371
"IL","Cook Suburbs","91700104",617600,336627,0.64722545054793,280973
"IL","Crawford","17033",2855,5577,0.338591081593928,-2722
"IL","Cumberland","17035",1640,3506,0.318694131364166,-1866
"IL","DeKalb","17037",21171,18906,0.528258103151434,2265
"IL","DeWitt","17039",2598,4576,0.362141064956788,-1978
"IL","Douglas","17041",2426,5331,0.312749774397319,-2905
"IL","DuPage","17043",197411,193333,0.505218250312225,4078
"IL","Edgar","17045",2563,5125,0.33337669094693,-2562
"IL","Edwards","17047",754,2402,0.238910012674271,-1648
"IL","Effingham","17049",3855,12491,0.235837513764835,-8636
"IL","Fayette","17051",2848,5950,0.323709934075926,-3102
"IL","Ford","17053",1654,4225,0.281340364007484,-2571
"IL","Franklin","17055",7245,10253,0.414047319693679,-3008
"IL","Fulton","17057",8324,6622,0.556938311253847,1702
"IL","Gallatin","17059",1028,1492,0.407936507936508,-464
"IL","Greene","17061",2023,3446,0.369903090144451,-1423
"IL","Grundy","17063",9319,11198,0.454208704976361,-1879
"IL","Hamilton","17065",1266,2566,0.330375782881002,-1300
"IL","Hancock","17067",3246,4810,0.402929493545184,-1564
"IL","Hardin","17069",742,1535,0.32586736934563,-793
"IL","Henderson","17071",1977,1538,0.562446657183499,439
"IL","Henry","17073",12316,11564,0.515745393634841,752
"IL","Iroquois","17075",3408,9115,0.272139263754691,-5707
"IL","Jackson","17077",11306,9130,0.553239381483656,2176
"IL","Jasper","17079",1434,3511,0.289989888776542,-2077
"IL","Jefferson","17081",6080,9805,0.382751022977652,-3725
"IL","Jersey","17083",3656,6032,0.37737407101569,-2376
"IL","JoDaviess","17085",5660,5529,0.505853963714362,131
"IL","Johnson","17087",1571,3959,0.284086799276673,-2388
"IL","Kane","17089",91120,89502,0.504478967124714,1618
"IL","Kankakee","17091",21574,23115,0.482758620689655,-1541
"IL","Kendall","17093",21219,23076,0.479038266169997,-1857
"IL","Knox","17095",12993,9133,0.587227695923348,3860
"IL","Lake","17097",151552,128609,0.540946098850304,22943
"IL","LaSalle","17099",23023,23207,0.498009950248756,-184
"IL","Lawrence","17101",2010,3853,0.342827903803514,-1843
"IL","Lee","17103",6932,8046,0.462812124449192,-1114
"IL","Livingston","17105",5014,9745,0.339724913612033,-4731
"IL","Logan","17107",3974,7835,0.336522990939114,-3861
"IL","Macon","17115",22688,25249,0.473287856978952,-2561
"IL","Macoupin","17117",9440,10909,0.46390486018969,-1469
"IL","Madison","17119",58813,60481,0.493008868845038,-1668
"IL","Marion","17121",6210,9229,0.402228123583134,-3019
"IL","Marshall","17123",2452,3287,0.427252134518209,-835
"IL","Mason","17125",2867,3265,0.467547292889759,-398
"IL","Massac","17127",2092,4278,0.328414442700157,-2186
"IL","McDonough","17109",5957,6142,0.492354740061162,-185
"IL","McHenry","17111",59691,71488,0.455034723545689,-11797
"IL","McLean","17113",31590,39638,0.443505363059471,-8048
"IL","Menard","17129",2095,3944,0.346911740354363,-1849
"IL","Mercer","17131",4503,3874,0.53754327324818,629
"IL","Monroe","17133",6205,10879,0.36320533832826,-4674
"IL","Montgomery","17135",5053,6771,0.427351150202977,-1718
"IL","Morgan","17137",5792,7962,0.421113857786826,-2170
"IL","Moultrie","17139",2142,3781,0.36164106027351,-1639
"IL","Ogle","17141",9504,13409,0.414786365818531,-3905
"IL","Peoria","17143",40050,36617,0.52238903309116,3433
"IL","Perry","17145",3813,5497,0.409559613319012,-1684
"IL","Piatt","17147",3081,5412,0.362769339456023,-2331
"IL","Pike","17149",2276,4853,0.319259363164539,-2577
"IL","Pope","17151",649,1511,0.300462962962963,-862
"IL","Pulaski","17153",1389,1562,0.470687902405964,-173
"IL","Putnam","17155",1558,1500,0.509483322432963,58
"IL","Randolph","17157",5753,8284,0.409845408563083,-2531
"IL","Richland","17159",2360,4750,0.331926863572433,-2390
"IL","Rock Island","17161",39081,24888,0.610936547390142,14193
"IL","Saline","17165",3697,6803,0.352095238095238,-3106
"IL","Sangamon","17167",41961,50131,0.455642183903053,-8170
"IL","Schuyler","17169",1726,2062,0.455649419218585,-336
"IL","Scott","17171",910,1586,0.364583333333333,-676
"IL","Shelby","17173",3336,6837,0.327926865231495,-3501
"IL","St. Clair","17163",66749,49610,0.573647075000645,17139
"IL","Stark","17175",1095,1527,0.417620137299771,-432
"IL","Stephenson","17177",7954,8742,0.47640153330139,-788
"IL","Tazewell","17179",24385,35266,0.408794487938174,-10881
"IL","Union","17181",3135,4951,0.387707148157309,-1816
"IL","Vermilion","17183",10773,14888,0.419819960250965,-4115
"IL","Wabash","17185",1588,3473,0.313771981821774,-1885
"IL","Warren","17187",3893,3460,0.529443764449884,433
"IL","Washington","17189",2448,4787,0.338355217691776,-2339
"IL","Wayne","17191",1514,5984,0.20192051213657,-4470
"IL","White","17193",2187,4729,0.316223250433777,-2542
"IL","Whiteside","17195",12393,8676,0.588210166595472,3717
"IL","Will","17197",127522,118366,0.518618232691307,9156
"IL","Williamson","17199",10622,17880,0.372675601712161,-7258
"IL","Winnebago","17201",60334,53722,0.528985761380375,6612
"IL","Woodford","17203",5564,12947,0.300578034682081,-7383
"IN","Adams","18001",3800,8936,0.298366834170854,-5136
"IN","Allen","18003",59834,84378,0.414903059384795,-24544
"IN","Bartholomew","18005",10622,18083,0.370040062706845,-7461
"IN","Benton","18007",1159,2329,0.332282110091743,-1170
"IN","Blackford","18009",1927,2710,0.415570411904248,-783
"IN","Boone","18011",8326,18807,0.306858806619246,-10481
"IN","Brown","18013",3056,4330,0.413755754129434,-1274
"IN","Carroll","18015",2631,4993,0.3450944386149,-2362
"IN","Cass","18017",5365,8432,0.388852649126622,-3067
"IN","Clark","18019",20775,25422,0.449704526267939,-4647
"IN","Clay","18021",3630,7065,0.339410939691445,-3435
"IN","Clinton","18023",3307,6338,0.342871954380508,-3031
"IN","Crawford","18025",2040,2418,0.457604306864065,-378
"IN","Daviess","18027",2437,7638,0.241885856079404,-5201
"IN","Dearborn","18029",6527,15391,0.297791769322018,-8864
"IN","Decatur","18031",2941,7119,0.29234592445328,-4178
"IN","DeKalb","18033",5419,10586,0.338581693220868,-5167
"IN","Delaware","18035",22630,21231,0.515948108798249,1399
"IN","Dubois","18037",6522,11654,0.358824823943662,-5132
"IN","Elkhart","18039",24376,42348,0.365325819794976,-17972
"IN","Fayette","18041",3553,5044,0.413283703617541,-1491
"IN","Floyd","18043",14805,19868,0.426989300031725,-5063
"IN","Fountain","18045",2233,4660,0.323951835195125,-2427
"IN","Franklin","18047",2907,7421,0.281467854376452,-4514
"IN","Fulton","18049",2621,5315,0.330267137096774,-2694
"IN","Gibson","18051",4928,9487,0.341866111689213,-4559
"IN","Grant","18053",9589,15148,0.38763795124712,-5559
"IN","Greene","18055",4340,8457,0.339141986403063,-4117
"IN","Hamilton","18057",43794,90740,0.325523659446683,-46946
"IN","Hancock","18059",9303,22750,0.290238043240882,-13447
"IN","Harrison","18061",6600,10629,0.383075047884381,-4029
"IN","Hendricks","18063",21100,44308,0.322590508806262,-23208
"IN","Henry","18065",7613,10836,0.412651092200119,-3223
"IN","Howard","18067",15097,20284,0.426697945224838,-5187
"IN","Huntington","18069",4596,10862,0.297321775132617,-6266
"IN","Jackson","18071",5838,10419,0.359106846281602,-4581
"IN","Jasper","18073",4672,7955,0.37000079195375,-3283
"IN","Jay","18075",3063,4643,0.397482481183493,-1580
"IN","Jefferson","18077",5728,7096,0.446662507797879,-1368
"IN","Jennings","18079",3818,6112,0.384491440080564,-2294
"IN","Johnson","18081",17080,39136,0.303828091646506,-22056
"IN","Knox","18083",5228,9612,0.352291105121294,-4384
"IN","Kosciusko","18085",6862,22553,0.233282338942716,-15691
"IN","LaGrange","18087",2897,6227,0.317514248136782,-3330
"IN","Lake","18089",130824,68397,0.656677759874712,62427
"IN","LaPorte","18091",24104,18609,0.564324678669258,5495
"IN","Lawrence","18093",5779,11622,0.33210735015229,-5843
"IN","Madison","18095",24404,26755,0.477022615766532,-2351
"IN","Marion","18097",215474,136131,0.612829737916127,79343
"IN","Marshall","18099",6136,11260,0.352724764313635,-5124
"IN","Martin","18101",1351,3262,0.292867981790592,-1911
"IN","Miami","18103",4220,8163,0.340789792457401,-3943
"IN","Monroe","18105",22885,16254,0.584710902169192,6631
"IN","Montgomery","18107",4244,9768,0.302883242934627,-5524
"IN","Morgan","18109",7969,19591,0.289150943396226,-11622
"IN","Newton","18111",2212,3291,0.40196256587316,-1079
"IN","Noble","18113",5229,10680,0.328681878182161,-5451
"IN","Ohio","18115",992,1757,0.360858493997817,-765
"IN","Orange","18117",2939,4615,0.389065395816786,-1676
"IN","Owen","18119",2823,5062,0.358021559923906,-2239
"IN","Parke","18121",2106,4228,0.332491316703505,-2122
"IN","Perry","18123",4314,3403,0.559025528054944,911
"IN","Pike","18125",2125,3627,0.369436717663421,-1502
"IN","Porter","18127",36950,34197,0.519347266926223,2753
"IN","Posey","18129",4531,7427,0.378909516641579,-2896
"IN","Pulaski","18131",1899,3366,0.360683760683761,-1467
"IN","Putnam","18133",4504,9004,0.333432040272431,-4500
"IN","Randolph","18135",3768,6218,0.377328259563389,-2450
"IN","Ripley","18137",3241,7484,0.302191142191142,-4243
"IN","Rush","18139",2221,4633,0.324044353662095,-2412
"IN","Scott","18143",3998,4539,0.468314396157901,-541
"IN","Shelby","18145",5357,10972,0.328066629922224,-5615
"IN","Spencer","18147",4026,5515,0.421968347133424,-1489
"IN","St. Joseph","18141",56458,52575,0.517806535636,3883
"IN","Starke","18149",3809,4738,0.445653445653446,-929
"IN","Steuben","18151",4846,8542,0.361965939647446,-3696
"IN","Sullivan","18153",3191,4902,0.394291362906215,-1711
"IN","Switzerland","18155",1437,1872,0.43427017225748,-435
"IN","Tippecanoe","18157",26642,28708,0.4813369467028,-2066
"IN","Tipton","18159",2432,4773,0.337543372657876,-2341
"IN","Union","18161",1018,2022,0.334868421052632,-1004
"IN","Vanderburgh","18163",31659,39504,0.444880064078243,-7845
"IN","Vermillion","18165",2979,3426,0.465105386416862,-447
"IN","Vigo","18167",19707,19368,0.504337811900192,339
"IN","Wabash","18169",3929,8528,0.315404993176527,-4599
"IN","Warren","18171",1324,2377,0.357741151040259,-1053
"IN","Warrick","18173",8791,15350,0.364152272068266,-6559
"IN","Washington","18175",3909,6532,0.374389426300163,-2623
"IN","Wayne","18177",10591,14321,0.425136480411047,-3730
"IN","Wells","18179",3434,9255,0.270628103081409,-5821
"IN","White","18181",3635,5970,0.378448724622592,-2335
"IN","Whitley","18183",4420,10257,0.301151461470328,-5837
"KS","Allen","20001",1842,3261,0.360964138741917,-1419
"KS","Anderson","20003",937,2246,0.294376374489475,-1309
"KS","Atchison","20005",2486,3836,0.393229990509332,-1350
"KS","Barber","20007",473,1753,0.212488769092543,-1280
"KS","Barton","20009",2693,9132,0.227737843551797,-6439
"KS","Bourbon","20011",1951,4022,0.326636531056421,-2071
"KS","Brown","20013",1039,2738,0.27508604712735,-1699
"KS","Butler","20015",7124,17764,0.286242365798779,-10640
"KS","Chase","20017",343,857,0.285833333333333,-514
"KS","Chautauqua","20019",259,1201,0.177397260273973,-942
"KS","Cherokee","20021",2868,5345,0.34920248386704,-2477
"KS","Cheyenne","20023",231,1157,0.1664265129683,-926
"KS","Clark","20025",171,791,0.177754677754678,-620
"KS","Clay","20027",811,2715,0.230005672149745,-1904
"KS","Cloud","20029",951,2886,0.247849882720876,-1935
"KS","Coffey","20031",884,2860,0.236111111111111,-1976
"KS","Comanche","20033",141,756,0.157190635451505,-615
"KS","Cowley","20035",4219,7932,0.347214221051765,-3713
"KS","Crawford","20037",6545,7480,0.466666666666667,-935
"KS","Decatur","20039",266,1219,0.179124579124579,-953
"KS","Dickinson","20041",1962,5709,0.25576847868596,-3747
"KS","Doniphan","20043",885,2397,0.269652650822669,-1512
"KS","Douglas","20045",28012,17028,0.621936056838366,10984
"KS","Edwards","20047",291,1048,0.217326362957431,-757
"KS","Elk","20049",277,1040,0.210326499620349,-763
"KS","Ellis","20051",3464,9057,0.276655219231691,-5593
"KS","Ellsworth","20053",696,1905,0.267589388696655,-1209
"KS","Finney","20055",2307,5108,0.311126095751854,-2801
"KS","Ford","20057",2468,5459,0.311340986501829,-2991
"KS","Franklin","20059",3611,6893,0.343773800456969,-3282
"KS","Geary","20061",3158,4242,0.426756756756757,-1084
"KS","Gove","20063",174,1155,0.130925507900677,-981
"KS","Graham","20065",248,1044,0.191950464396285,-796
"KS","Grant","20067",437,1742,0.200550711335475,-1305
"KS","Gray","20069",304,1568,0.162393162393162,-1264
"KS","Greeley","20071",112,539,0.172043010752688,-427
"KS","Greenwood","20073",653,1986,0.247442212959454,-1333
"KS","Hamilton","20075",159,678,0.189964157706093,-519
"KS","Harper","20077",536,1723,0.237273129703409,-1187
"KS","Harvey","20079",5162,8352,0.381974248927039,-3190
"KS","Haskell","20081",202,1131,0.151537884471118,-929
"KS","Hodgeman","20083",178,857,0.171980676328502,-679
"KS","Jackson","20085",1870,3476,0.349794238683128,-1606
"KS","Jefferson","20087",2883,4647,0.382868525896414,-1764
"KS","Jewell","20089",225,1220,0.155709342560554,-995
"KS","Johnson","20091",107651,155442,0.409174702481632,-47791
"KS","Kearny","20093",261,1060,0.197577592732778,-799
"KS","Kingman","20095",731,2371,0.23565441650548,-1640
"KS","Kiowa","20097",160,970,0.141592920353982,-810
"KS","Labette","20099",3074,4668,0.397055024541462,-1594
"KS","Lane","20101",170,732,0.188470066518847,-562
"KS","Leavenworth","20103",11072,16825,0.396888554324838,-5753
"KS","Lincoln","20105",284,1148,0.198324022346369,-864
"KS","Linn","20107",1108,3079,0.264628612371626,-1971
"KS","Logan","20109",194,1084,0.151799687010955,-890
"KS","Lyon","20111",4972,6358,0.438834951456311,-1386
"KS","Marion","20115",1371,3865,0.261841100076394,-2494
"KS","Marshall","20117",1451,3123,0.317227809357237,-1672
"KS","McPherson","20113",3384,8399,0.287193414240855,-5015
"KS","Meade","20119",254,1394,0.154126213592233,-1140
"KS","Miami","20121",4635,9726,0.322749112178818,-5091
"KS","Mitchell","20123",576,2293,0.200766817706518,-1717
"KS","Montgomery","20125",3406,8417,0.288082550959993,-5011
"KS","Morris","20127",705,1750,0.287169042769857,-1045
"KS","Morton","20129",180,1050,0.146341463414634,-870
"KS","Nemaha","20131",988,3878,0.203041512535964,-2890
"KS","Neosho","20133",2012,4193,0.324254633360193,-2181
"KS","Ness","20135",211,1190,0.150606709493219,-979
"KS","Norton","20137",393,1855,0.17482206405694,-1462
"KS","Osage","20139",2228,4336,0.339427178549665,-2108
"KS","Osborne","20141",320,1448,0.180995475113122,-1128
"KS","Ottawa","20143",548,2260,0.195156695156695,-1712
"KS","Pawnee","20145",704,1808,0.280254777070064,-1104
"KS","Phillips","20147",376,2116,0.150882825040128,-1740
"KS","Pottawatomie","20149",2291,6692,0.255037292663921,-4401
"KS","Pratt","20151",974,2730,0.262958963282937,-1756
"KS","Rawlins","20153",184,1207,0.132278936017254,-1023
"KS","Reno","20155",7888,15398,0.338744309885768,-7510
"KS","Republic","20157",470,2098,0.183021806853583,-1628
"KS","Rice","20159",899,2631,0.254674220963173,-1732
"KS","Riley","20161",8587,11157,0.434916936790924,-2570
"KS","Rooks","20163",398,2159,0.155651153695737,-1761
"KS","Rush","20165",361,1151,0.238756613756614,-790
"KS","Russell","20167",584,2505,0.189057947555843,-1921
"KS","Saline","20169",6910,13697,0.335322948512641,-6787
"KS","Scott","20171",271,1702,0.137354282818044,-1431
"KS","Sedgwick","20173",69373,104411,0.399190949684666,-35038
"KS","Seward","20175",1393,3495,0.284983633387889,-2102
"KS","Shawnee","20177",35959,37226,0.491343854615017,-1267
"KS","Sheridan","20179",165,1136,0.126825518831668,-971
"KS","Sherman","20181",575,1967,0.226199842643588,-1392
"KS","Smith","20183",345,1598,0.177560473494596,-1253
"KS","Stafford","20185",403,1382,0.225770308123249,-979
"KS","Stanton","20187",135,571,0.191218130311615,-436
"KS","Stevens","20189",241,1724,0.12264631043257,-1483
"KS","Sumner","20191",2617,6162,0.298097733227019,-3545
"KS","Thomas","20193",576,2729,0.17428139183056,-2153
"KS","Trego","20195",289,1230,0.190256747860435,-941
"KS","Wabaunsee","20197",908,2230,0.289356277884003,-1322
"KS","Wallace","20199",68,702,0.0883116883116883,-634
"KS","Washington","20201",515,2300,0.182948490230906,-1785
"KS","Wichita","20203",157,821,0.160531697341513,-664
"KS","Wilson","20205",813,2812,0.224275862068966,-1999
"KS","Woodson","20207",377,1030,0.267945984363895,-653
"KS","Wyandotte","20209",33265,15273,0.685339321768511,17992
"KY","Adair","21001",1660,5841,0.221303826156512,-4181
"KY","Allen","21003",1808,5184,0.258581235697941,-3376
"KY","Anderson","21005",3315,6822,0.327019828351583,-3507
"KY","Ballard","21007",1189,2647,0.309958289885297,-1458
"KY","Barren","21009",5400,10922,0.330841808601887,-5522
"KY","Bath","21011",1770,2275,0.437577255871446,-505
"KY","Bell","21013",2224,7127,0.237835525612234,-4903
"KY","Boone","21015",15628,35920,0.303173740979281,-20292
"KY","Bourbon","21017",3075,4692,0.395905755117806,-1617
"KY","Boyd","21019",7776,10883,0.416742590706897,-3107
"KY","Boyle","21021",4471,7703,0.367258091013636,-3232
"KY","Bracken","21023",1147,2029,0.361146095717884,-882
"KY","Breathitt","21025",1562,3318,0.320081967213115,-1756
"KY","Breckinridge","21027",2825,5025,0.359872611464968,-2200
"KY","Bullitt","21029",9971,21306,0.318796559772357,-11335
"KY","Butler","21031",1293,3716,0.258135356358555,-2423
"KY","Caldwell","21033",1852,3904,0.321751216122307,-2052
"KY","Calloway","21035",5314,9438,0.360222342733189,-4124
"KY","Campbell","21037",15080,24240,0.38351983723296,-9160
"KY","Carlisle","21039",750,1835,0.290135396518375,-1085
"KY","Carroll","21041",1629,1999,0.449007717750827,-370
"KY","Carter","21043",3383,5279,0.390556453474948,-1896
"KY","Casey","21045",1086,4904,0.181302170283806,-3818
"KY","Christian","21047",8252,13475,0.379803930593271,-5223
"KY","Clark","21049",5228,9931,0.344877630450557,-4703
"KY","Clay","21051",1111,6176,0.152463290791821,-5065
"KY","Clinton","21053",752,3569,0.17403378847489,-2817
"KY","Crittenden","21055",960,2839,0.252698078441695,-1879
"KY","Cumberland","21057",599,2216,0.212788632326821,-1617
"KY","Daviess","21059",16208,25092,0.392445520581114,-8884
"KY","Edmonson","21061",1374,3232,0.298306556665219,-1858
"KY","Elliott","21063",1186,1126,0.512975778546713,60
"KY","Estill","21065",1356,3749,0.26562193927522,-2393
"KY","Fayette","21067",62078,60793,0.50522906137331,1285
"KY","Fleming","21069",1911,3780,0.335793357933579,-1869
"KY","Floyd","21071",4733,9784,0.326031549218158,-5051
"KY","Franklin","21073",11535,11345,0.504152097902098,190
"KY","Fulton","21075",1022,1425,0.417654270535349,-403
"KY","Gallatin","21077",1238,1758,0.413217623497997,-520
"KY","Garrard","21079",1661,5310,0.238272844642089,-3649
"KY","Grant","21081",2810,5664,0.33160254897333,-2854
"KY","Graves","21083",4547,10699,0.298242161878526,-6152
"KY","Grayson","21085",2744,6404,0.29995627459554,-3660
"KY","Green","21087",1165,3634,0.242758908105855,-2469
"KY","Greenup","21089",6027,8855,0.404985888993415,-2828
"KY","Hancock","21091",1833,2212,0.453152039555006,-379
"KY","Hardin","21093",15214,23357,0.394441419719478,-8143
"KY","Harlan","21095",1830,8653,0.174568348755127,-6823
"KY","Harrison","21097",2471,4556,0.351643660167924,-2085
"KY","Hart","21099",2283,4256,0.349135953509711,-1973
"KY","Henderson","21101",8091,10296,0.440039158100832,-2205
"KY","Henry","21103",2529,3940,0.390941412892255,-1411
"KY","Hickman","21105",686,1431,0.324043457723193,-745
"KY","Hopkins","21107",5789,13681,0.297329224447869,-7892
"KY","Jackson","21109",612,4365,0.122965641952984,-3753
"KY","Jefferson","21111",186164,148415,0.556412685793191,37749
"KY","Jessamine","21113",6001,14232,0.29659467207038,-8231
"KY","Johnson","21115",1723,7095,0.195395781356317,-5372
"KY","Kenton","21117",24917,41387,0.375799348455598,-16470
"KY","Knott","21119",1420,4130,0.255855855855856,-2710
"KY","Knox","21121",2484,8467,0.226828600127842,-5983
"KY","LaRue","21123",1733,3911,0.307051736357193,-2178
"KY","Laurel","21125",3905,18151,0.177049328980776,-14246
"KY","Lawrence","21127",1520,3995,0.275611967361741,-2475
"KY","Lee","21129",595,1977,0.231337480559876,-1382
"KY","Leslie","21131",433,4439,0.0888752052545156,-4006
"KY","Letcher","21133",1702,6811,0.199929519558323,-5109
"KY","Lewis","21135",1342,3326,0.287489288774636,-1984
"KY","Lincoln","21137",2582,6416,0.28695265614581,-3834
"KY","Livingston","21139",1346,3089,0.303494926719278,-1743
"KY","Logan","21141",3469,6899,0.334587191358025,-3430
"KY","Lyon","21143",1373,2412,0.362747688243065,-1039
"KY","Madison","21151",11512,21128,0.352696078431373,-9616
"KY","Magoffin","21153",1433,3391,0.297056384742952,-1958
"KY","Marion","21155",3418,3800,0.473538376281518,-382
"KY","Marshall","21157",5022,10402,0.325596473029046,-5380
"KY","Martin","21159",574,3180,0.152903569525839,-2606
"KY","Mason","21161",2592,4197,0.38179407865665,-1605
"KY","McCracken","21145",10062,19979,0.334942245597683,-9917
"KY","McCreary","21147",1069,4564,0.189774542872359,-3495
"KY","McLean","21149",1432,2705,0.346144549190234,-1273
"KY","Meade","21163",4122,6606,0.384228187919463,-2484
"KY","Menifee","21165",1048,1484,0.41390205371248,-436
"KY","Mercer","21167",2966,6820,0.303086041283466,-3854
"KY","Metcalfe","21169",1425,2676,0.3474762253109,-1251
"KY","Monroe","21171",936,3762,0.199233716475096,-2826
"KY","Montgomery","21173",3701,6398,0.366471927913655,-2697
"KY","Morgan","21175",1369,3021,0.311845102505695,-1652
"KY","Muhlenberg","21177",4771,7762,0.380675017952605,-2991
"KY","Nelson","21179",7611,10673,0.416265587398819,-3062
"KY","Nicholas","21181",948,1583,0.374555511655472,-635
"KY","Ohio","21183",2987,6470,0.31585069260865,-3483
"KY","Oldham","21185",9240,20179,0.314082735647031,-10939
"KY","Owen","21187",1501,2971,0.335644007155635,-1470
"KY","Owsley","21189",283,1279,0.181177976952625,-996
"KY","Pendleton","21191",1859,3556,0.343305632502308,-1697
"KY","Perry","21193",2047,8040,0.202934470110043,-5993
"KY","Pike","21195",5645,17589,0.242962899199449,-11944
"KY","Powell","21197",1620,2726,0.372756557754257,-1106
"KY","Pulaski","21199",4976,20714,0.193694044375243,-15738
"KY","Robertson","21201",340,579,0.369967355821545,-239
"KY","Rockcastle","21203",1097,5028,0.179102040816327,-3931
"KY","Rowan","21205",3438,4035,0.460056202328382,-597
"KY","Russell","21207",1445,6346,0.185470414580927,-4901
"KY","Scott","21209",7532,12679,0.372668348918906,-5147
"KY","Shelby","21211",6634,11790,0.360073816760747,-5156
"KY","Simpson","21213",2650,4355,0.378301213418986,-1705
"KY","Spencer","21215",2549,5726,0.308036253776435,-3177
"KY","Taylor","21217",3284,7551,0.303091832025842,-4267
"KY","Todd","21219",1403,3247,0.301720430107527,-1844
"KY","Trigg","21221",2115,4520,0.318764129615674,-2405
"KY","Trimble","21223",1355,2133,0.388474770642202,-778
"KY","Union","21225",1941,3952,0.329373833361615,-2011
"KY","Warren","21227",16805,26384,0.389103706962421,-9579
"KY","Washington","21229",1669,3495,0.323199070487994,-1826
"KY","Wayne","21231",1855,5289,0.259658454647256,-3434
"KY","Webster","21233",1765,3607,0.32855547282204,-1842
"KY","Whitley","21235",2683,10232,0.207742934572203,-7549
"KY","Wolfe","21237",976,1542,0.387609213661636,-566
"KY","Woodford","21239",4883,7218,0.403520370217337,-2335
"LA","Acadia","22001",6559,19931,0.247602869007173,-13372
"LA","Allen","22003",2616,6495,0.287125452749424,-3879
"LA","Ascension","22005",16343,33846,0.325629121919146,-17503
"LA","Assumption","22007",4754,6082,0.438722775932078,-1328
"LA","Avoyelles","22009",6075,10667,0.362859873372357,-4592
"LA","Beauregard","22011",2827,11111,0.202826804419572,-8284
"LA","Bienville","22013",3490,3641,0.489412424624877,-151
"LA","Bossier","22015",12955,34986,0.270227988569283,-22031
"LA","Caddo","22017",57879,52378,0.524946261915343,5501
"LA","Calcasieu","22019",28357,51844,0.353574144960786,-23487
"LA","Caldwell","22021",1016,3640,0.218213058419244,-2624
"LA","Cameron","22023",408,3260,0.11123227917121,-2852
"LA","Catahoula","22025",1408,2744,0.339113680154143,-1336
"LA","Claiborne","22027",3014,3649,0.45234879183551,-635
"LA","Concordia","22029",3833,5450,0.412905310783152,-1617
"LA","DeSoto","22031",5552,7353,0.430220844633863,-1801
"LA","East Baton Rouge","22033",102460,92235,0.526259020519274,10225
"LA","East Carroll","22035",2244,1122,0.666666666666667,1122
"LA","East Feliciana","22037",4648,5397,0.462717770034843,-749
"LA","Evangeline","22039",5330,10176,0.343737907906617,-4846
"LA","Franklin","22041",2921,6294,0.316983179598481,-3373
"LA","Grant","22043",1421,7082,0.167117487945431,-5661
"LA","Iberia","22045",12129,20890,0.367333959235592,-8761
"LA","Iberville","22047",9548,7271,0.567691301504251,2277
"LA","Jackson","22049",2305,5132,0.309936802474116,-2827
"LA","Jeff Davis","22053",3483,10014,0.258057346076906,-6531
"LA","Jefferson","22051",70000,102325,0.406209197736834,-32325
"LA","Lafayette","22055",31766,64989,0.328313782233476,-33223
"LA","Lafourche","22057",9543,28332,0.251960396039604,-18789
"LA","LaSalle","22059",764,5726,0.117719568567026,-4962
"LA","Lincoln","22061",7947,10731,0.425473819466752,-2784
"LA","Livingston","22063",7448,45488,0.140698201601934,-38040
"LA","Madison","22065",3154,2000,0.611951882033372,1154
"LA","Morehouse","22067",5887,6591,0.471790351017791,-704
"LA","Natchitoches","22069",7941,9077,0.466623575038195,-1136
"LA","Orleans","22071",126199,27967,0.818591647963883,98232
"LA","Ouachita","22073",26629,40927,0.394176683048138,-14298
"LA","Plaquemines","22075",3597,6469,0.357341545797735,-2872
"LA","Pointe Coupee","22077",5436,6548,0.453604806408545,-1112
"LA","Rapides","22079",20040,37187,0.350184353539413,-17147
"LA","Red River","22081",2253,2483,0.475717905405405,-230
"LA","Richland","22083",4074,7316,0.357682177348551,-3242
"LA","Sabine","22085",2194,7735,0.220968879041192,-5541
"LA","St. Bernard","22087",5052,8497,0.372868846409329,-3445
"LA","St. Charles","22089",8894,15936,0.3581957309706,-7042
"LA","St. Helena","22091",4233,2756,0.605666046644727,1477
"LA","St. James","22093",7055,5209,0.575260926288324,1846
"LA","St. John the Baptist","22095",13178,7620,0.633618617174728,5558
"LA","St. Landry","22097",19668,21475,0.478040006805532,-1807
"LA","St. Martin","22099",9419,15653,0.375678047223995,-6234
"LA","St. Mary","22101",9448,13883,0.404954781192405,-4435
"LA","St. Tammany","22103",25723,84710,0.232928563020112,-58987
"LA","Tangipahoa","22105",17720,31583,0.359410177879642,-13863
"LA","Tensas","22107",1564,1230,0.559770937723694,334
"LA","Terrebonne","22109",12071,29500,0.290370691106781,-17429
"LA","Union","22111",3075,7561,0.28911244828883,-4486
"LA","Vermilion","22113",5718,18909,0.232184188086247,-13191
"LA","Vernon","22115",3173,12146,0.207128402637248,-8973
"LA","Washington","22117",6351,11470,0.356377307670726,-5119
"LA","Webster","22119",6802,11397,0.373756799824166,-4595
"LA","West Baton Rouge","22121",5692,6920,0.451316206787187,-1228
"LA","West Carroll","22123",853,3628,0.190359294800268,-2775
"LA","West Feliciana","22125",2441,3257,0.428395928395928,-816
"LA","Winn","22127",1919,4539,0.297150820687519,-2620
"MA","Abington","92500001",4104,4051,0.503249540159411,53
"MA","Acton","92500002",7779,3851,0.668873602751505,3928
"MA","Acushnet","92500003",3021,2183,0.580514988470407,838
"MA","Adams","92500004",3010,818,0.786311389759666,2192
"MA","Agawam","92500005",7288,6870,0.514761972029948,418
"MA","Alford","92500006",233,64,0.784511784511784,169
"MA","Amesbury","92500007",4817,3446,0.58296018395256,1371
"MA","Amherst","92500008",12316,1872,0.868057513391599,10444
"MA","Andover","92500009",9287,9053,0.506379498364231,234
"MA","Aquinnah","92500104",251,38,0.868512110726644,213
"MA","Arlington","92500010",18580,6659,0.736162288521732,11921
"MA","Ashburnham","92500011",1621,1529,0.514603174603175,92
"MA","Ashby","92500012",827,961,0.462527964205817,-134
"MA","Ashfield","92500013",892,187,0.826691380908248,705
"MA","Ashland","92500014",4954,3407,0.592512857313718,1547
"MA","Athol","92500015",2525,2070,0.549510337323177,455
"MA","Attleboro","92500016",10369,8406,0.552276964047936,1963
"MA","Auburn","92500017",4495,4116,0.522006735570782,379
"MA","Avon","92500018",1221,1131,0.519132653061224,90
"MA","Ayer","92500019",2023,1557,0.565083798882682,466
"MA","Barnstable","92500020",12842,12290,0.510982014961006,552
"MA","Barre","92500021",1343,1279,0.512204424103738,64
"MA","Becket","92500022",684,259,0.725344644750795,425
"MA","Bedford","92500023",4436,3046,0.592889601710773,1390
"MA","Belchertown","92500024",4542,2886,0.611470113085622,1656
"MA","Bellingham","92500025",4256,1119,0.791813953488372,3137
"MA","Belmont","92500026",9108,4728,0.658282740676496,4380
"MA","Berkley","92500027",1569,1686,0.482027649769585,-117
"MA","Berlin","92500028",917,830,0.524899828277046,87
"MA","Bernardston","92500029",809,329,0.710896309314587,480
"MA","Beverly","92500030",12075,8304,0.592521713528632,3771
"MA","Billerica","92500031",9774,9925,0.496167318137977,-151
"MA","Blackstone","92500032",2221,2027,0.522834274952919,194
"MA","Blandford","92500033",300,348,0.462962962962963,-48
"MA","Bolton","92500034",1537,1457,0.513360053440214,80
"MA","Boston","92500035",196096,48227,0.802609660162981,147869
"MA","Bourne","92500036",4719,5252,0.473272490221643,-533
"MA","Boxborough","92500037",1737,1134,0.605015673981191,603
"MA","Boxford","92500038",2049,3032,0.403267073410746,-983
"MA","Boylston","92500039",1284,1341,0.489142857142857,-57
"MA","Braintree","92500040",10015,9217,0.520746672212978,798
"MA","Brewster","92500041",3669,2748,0.571762505843852,921
"MA","Bridgewater","92500042",5774,6089,0.486723425777628,-315
"MA","Brimfield","92500043",897,1094,0.450527373179307,-197
"MA","Brockton","92500044",25140,8668,0.743610979649787,16472
"MA","Brookfield","92500045",822,853,0.490746268656716,-31
"MA","Brookline","92500046",21761,5717,0.791942645025111,16044
"MA","Buckland","92500047",750,252,0.748502994011976,498
"MA","Burlington","92500048",6971,6187,0.529791761665907,784
"MA","Cambridge","92500049",41991,5340,0.887177536920834,36651
"MA","Canton","92500050",6430,5752,0.527827942866524,678
"MA","Carlisle","92500051",1959,1318,0.597802868477266,641
"MA","Carver","92500052",2870,3107,0.480174000334616,-237
"MA","Charlemont","92500053",456,166,0.733118971061093,290
"MA","Charlton","92500054",2910,3660,0.442922374429224,-750
"MA","Chatham","92500055",2287,2278,0.500985761226725,9
"MA","Chelmsford","92500056",9606,9534,0.501880877742947,72
"MA","Chelsea","92500057",6760,1510,0.817412333736397,5250
"MA","Cheshire","92500058",1216,493,0.71152720889409,723
"MA","Chester","92500059",331,305,0.520440251572327,26
"MA","Chesterfield","92500060",455,228,0.666178623718887,227
"MA","Chicopee","92500061",14292,8237,0.63438235163567,6055
"MA","Chilmark","92500062",585,127,0.821629213483146,458
"MA","Clarksburg","92500063",613,232,0.725443786982249,381
"MA","Clinton","92500064",3492,2451,0.587582029278142,1041
"MA","Cohasset","92500065",2226,2595,0.461729931549471,-369
"MA","Colrain","92500066",618,232,0.727058823529412,386
"MA","Concord","92500067",7282,3509,0.674821610601427,3773
"MA","Conway","92500068",926,288,0.762767710049423,638
"MA","Cummington","92500069",368,139,0.725838264299803,229
"MA","Dalton","92500070",2433,888,0.732610659439928,1545
"MA","Danvers","92500071",7344,6984,0.512562814070352,360
"MA","Dartmouth","92500072",9817,5964,0.622077181420696,3853
"MA","Dedham","92500073",7718,5719,0.574384163131651,1999
"MA","Deerfield","92500074",2103,839,0.714819850441876,1264
"MA","Dennis","92500075",4892,4244,0.535464098073555,648
"MA","Dighton","92500076",1743,1842,0.486192468619247,-99
"MA","Douglas","92500077",1894,2542,0.426961226330027,-648
"MA","Dover","92500078",1531,2004,0.433097595473833,-473
"MA","Dracut","92500079",6925,8026,0.463179720420039,-1101
"MA","Dudley","92500080",2466,2544,0.492215568862275,-78
"MA","Dunstable","92500081",819,1034,0.441985968699406,-215
"MA","Duxbury","92500082",4244,5325,0.443515518862995,-1081
"MA","East Bridgewater","92500083",3340,3867,0.463438323851811,-527
"MA","East Brookfield","92500084",469,662,0.414677276746242,-193
"MA","East Longmeadow","92500087",4085,4523,0.474558550185874,-438
"MA","Eastham","92500085",2187,1446,0.601981833195706,741
"MA","Easthampton","92500086",6281,2463,0.718321134492223,3818
"MA","Easton","92500088",5690,6162,0.480087748903139,-472
"MA","Edgartown","92500089",1699,827,0.672604908946952,872
"MA","Egremont","92500090",676,151,0.817412333736397,525
"MA","Erving","92500091",557,200,0.735799207397622,357
"MA","Essex","92500092",1154,962,0.545368620037807,192
"MA","Everett","92500093",9392,3582,0.72390935717589,5810
"MA","Fairhaven","92500094",5019,3082,0.619553141587458,1937
"MA","Fall River","92500095",21724,7323,0.747891348504148,14401
"MA","Falmouth","92500096",11013,8130,0.575301676853158,2883
"MA","Fitchburg","92500097",8504,5574,0.604063077141639,2930
"MA","Florida","92500098",254,127,0.666666666666667,127
"MA","Foxborough","92500099",4745,4798,0.497223095462643,-53
"MA","Framingham","92500100",18340,8938,0.672336681574896,9402
"MA","Franklin","92500101",8589,8549,0.501166997315906,40
"MA","Freetown","92500102",2301,2241,0.506605019815059,60
"MA","Gardner","92500103",4687,3323,0.585143570536829,1364
"MA","Georgetown","92500105",2272,2577,0.468550216539493,-305
"MA","Gill","92500106",646,212,0.752913752913753,434
"MA","Gloucester","92500107",9680,5511,0.637219406227371,4169
"MA","Goshen","92500108",395,198,0.66610455311973,197
"MA","Gosnold","92500109",49,36,0.576470588235294,13
"MA","Grafton","92500110",4853,4427,0.522952586206897,426
"MA","Granby","92500111",1862,1570,0.542540792540793,292
"MA","Granville","92500112",374,502,0.426940639269406,-128
"MA","Great Barrington","92500113",2916,595,0.830532611791512,2321
"MA","Greenfield","92500114",6175,1891,0.76555913711877,4284
"MA","Groton","92500115",3201,2806,0.53287830863992,395
"MA","Groveland","92500116",1824,2080,0.467213114754098,-256
"MA","Hadley","92500117",2119,886,0.705158069883527,1233
"MA","Halifax","92500118",997,2065,0.325604180274331,-1068
"MA","Hamilton","92500119",2163,2204,0.49530570185482,-41
"MA","Hampden","92500120",1286,1569,0.450437828371278,-283
"MA","Hancock","92500121",228,142,0.616216216216216,86
"MA","Hanover","92500122",3342,4910,0.404992729035385,-1568
"MA","Hanson","92500123",2512,2999,0.455815641444384,-487
"MA","Hardwick","92500124",710,559,0.559495665878645,151
"MA","Harvard","92500125",2166,1362,0.613945578231292,804
"MA","Harwich","92500126",4376,3607,0.548164850306902,769
"MA","Hatfield","92500127",1362,638,0.681,724
"MA","Haverhill","92500128",15342,11758,0.566125461254612,3584
"MA","Hawley","92500129",126,65,0.659685863874346,61
"MA","Heath","92500130",292,124,0.701923076923077,168
"MA","Hingham","92500131",6750,7231,0.482798083112796,-481
"MA","Hinsdale","92500132",728,297,0.710243902439024,431
"MA","Holbrook","92500133",3024,2402,0.557316623663841,622
"MA","Holden","92500134",5055,5294,0.488452990627114,-239
"MA","Holland","92500135",593,690,0.46219797349961,-97
"MA","Holliston","92500136",4621,3502,0.568878493167549,1119
"MA","Holyoke","92500137",12492,3639,0.774409522038311,8853
"MA","Hopedale","92500138",1698,1527,0.526511627906977,171
"MA","Hopkinton","92500139",4197,4334,0.49197046067284,-137
"MA","Hubbardston","92500140",1160,1381,0.456513183785911,-221
"MA","Hudson","92500141",5642,4183,0.574249363867684,1459
"MA","Hull","92500142",3576,2417,0.596696145503087,1159
"MA","Huntington","92500143",554,479,0.536302032913843,75
"MA","Ipswich","92500144",4417,3742,0.541365363402378,675
"MA","Kingston","92500145",3176,3724,0.460289855072464,-548
"MA","Lakeville","92500146",2411,3301,0.422093837535014,-890
"MA","Lancaster","92500147",1724,1914,0.473886750962067,-190
"MA","Lanesborough","92500148",1144,430,0.726810673443456,714
"MA","Lawrence","92500149",18240,3459,0.840591732337896,14781
"MA","Lee","92500150",2150,713,0.750960530911631,1437
"MA","Leicester","92500151",2744,2667,0.507115135834411,77
"MA","Lenox","92500152",2318,675,0.774473772134982,1643
"MA","Leominster","92500153",9769,8540,0.533562728712655,1229
"MA","Leverett","92500154",987,183,0.843589743589744,804
"MA","Lexington","92500155",12675,5287,0.705656385703151,7388
"MA","Leyden","92500156",339,115,0.746696035242291,224
"MA","Lincoln","92500157",2558,1055,0.707998892886798,1503
"MA","Littleton","92500158",2915,2357,0.552921092564492,558
"MA","Longmeadow","92500159",4851,3662,0.569834370962058,1189
"MA","Lowell","92500160",22597,10586,0.680981225326221,12011
"MA","Ludlow","92500161",5233,4295,0.549223341729639,938
"MA","Lunenburg","92500162",2748,3038,0.474939509160041,-290
"MA","Lynn","92500163",22965,8463,0.730717831233295,14502
"MA","Lynnfield","92500164",2773,4419,0.385567296996663,-1646
"MA","Malden","92500165",14940,5714,0.723346567250896,9226
"MA","Manchester","92500166",1886,1539,0.550656934306569,347
"MA","Mansfield","92500167",5910,5855,0.502337441563961,55
"MA","Marblehead","92500168",6824,5422,0.557243181447003,1402
"MA","Marion","92500169",1725,1456,0.542282301163156,269
"MA","Marlborough","92500170",9576,6867,0.582375478927203,2709
"MA","Marshfield","92500171",7041,7866,0.472328436305092,-825
"MA","Mashpee","92500172",4133,4058,0.504578195580515,75
"MA","Mattapoisett","92500173",2041,1855,0.523870636550308,186
"MA","Maynard","92500174",3635,2023,0.642453163662071,1612
"MA","Medfield","92500175",3448,3864,0.471553610503282,-416
"MA","Medford","92500176",18613,8294,0.691753075407886,10319
"MA","Medway","92500177",3615,3519,0.5067283431455,96
"MA","Melrose","92500178",9289,5936,0.610114942528736,3353
"MA","Mendon","92500179",1517,1840,0.451891569854036,-323
"MA","Merrimac","92500180",1844,1657,0.52670665524136,187
"MA","Methuen","92500181",11048,10168,0.520739064856712,880
"MA","Middleborough","92500182",5192,6029,0.462703858836111,-837
"MA","Middlefield","92500183",202,77,0.724014336917563,125
"MA","Middleton","92500184",1909,2651,0.418640350877193,-742
"MA","Milford","92500185",7129,5504,0.564315681152537,1625
"MA","Millbury","92500186",3410,3262,0.511091127098321,148
"MA","Millis","92500187",2421,2232,0.520309477756286,189
"MA","Millville","92500188",717,813,0.468627450980392,-96
"MA","Milton","92500189",9499,6122,0.608091671467896,3377
"MA","Monroe","92500190",32,21,0.60377358490566,11
"MA","Monson","92500191",2176,2032,0.517110266159696,144
"MA","Montague","92500192",3213,873,0.786343612334802,2340
"MA","Monterey","92500193",417,97,0.811284046692607,320
"MA","Montgomery","92500194",220,274,0.445344129554656,-54
"MA","Mount Washington","92500195",83,19,0.813725490196078,64
"MA","Nahant","92500196",1371,897,0.604497354497355,474
"MA","Nantucket","92500197",3828,2185,0.636620655246965,1643
"MA","Natick","92500198",11600,6757,0.631911532385466,4843
"MA","Needham","92500199",10207,6513,0.610466507177034,3694
"MA","New Ashford","92500200",107,40,0.727891156462585,67
"MA","New Bedford","92500201",25205,7541,0.769712331277103,17664
"MA","New Braintree","92500202",283,257,0.524074074074074,26
"MA","New Marlborough","92500205",572,240,0.704433497536946,332
"MA","New Salem","92500206",381,205,0.650170648464164,176
"MA","Newbury","92500203",2272,2100,0.519670631290027,172
"MA","Newburyport","92500204",6784,4059,0.625657105966983,2725
"MA","Newton","92500207",32099,12154,0.725351953539873,19945
"MA","Norfolk","92500208",2424,3199,0.431086608571937,-775
"MA","North Adams","92500209",4427,1144,0.794650870579788,3283
"MA","North Andover","92500211",6991,7992,0.466595474871521,-1001
"MA","North Attleborough","92500212",6602,7331,0.473839087059499,-729
"MA","North Brookfield","92500215",1050,1271,0.45239121068505,-221
"MA","North Reading","92500217",3986,4641,0.462037788338936,-655
"MA","Northampton","92500210",13110,2179,0.857479233435804,10931
"MA","Northborough","92500213",4387,3872,0.53117810872987,515
"MA","Northbridge","92500214",3408,4072,0.455614973262032,-664
"MA","Northfield","92500216",1115,473,0.702141057934509,642
"MA","Norton","92500218",4454,4449,0.500280804223296,5
"MA","Norwell","92500219",2714,3684,0.424195060956549,-970
"MA","Norwood","92500220",8098,6292,0.56275191104934,1806
"MA","Oak Bluffs","92500221",1955,795,0.710909090909091,1160
"MA","Oakham","92500222",509,609,0.455277280858676,-100
"MA","Orange","92500223",1818,1325,0.578428253261215,493
"MA","Orleans","92500224",2496,1922,0.564961521050249,574
"MA","Otis","92500225",489,311,0.61125,178
"MA","Oxford","92500226",3125,3261,0.489351706858754,-136
"MA","Palmer","92500227",3020,2482,0.548891312250091,538
"MA","Paxton","92500228",1119,1354,0.452486858067125,-235
"MA","Peabody","92500229",15010,11616,0.563734695410501,3394
"MA","Pelham","92500230",728,132,0.846511627906977,596
"MA","Pembroke","92500231",4574,5073,0.47413703742096,-499
"MA","Pepperell","92500232",2936,3426,0.461490097453631,-490
"MA","Peru","92500233",324,136,0.704347826086957,188
"MA","Petersham","92500234",451,338,0.571609632446134,113
"MA","Phillipston","92500235",464,469,0.497320471596999,-5
"MA","Pittsfield","92500236",15600,4044,0.794135613927917,11556
"MA","Plainfield","92500237",286,83,0.775067750677507,203
"MA","Plainville","92500238",2068,2269,0.476827299976943,-201
"MA","Plymouth","92500239",15106,14258,0.514439449666258,848
"MA","Plympton","92500240",776,928,0.455399061032864,-152
"MA","Princeton","92500241",1112,1148,0.492035398230089,-36
"MA","Provincetown","92500242",2121,210,0.90990990990991,1911
"MA","Quincy","92500243",24714,14816,0.625196053630154,9898
"MA","Randolph","92500244",11430,3550,0.7630173564753,7880
"MA","Raynham","92500245",3217,3657,0.467995344777422,-440
"MA","Reading","92500246",7447,6640,0.52864343011287,807
"MA","Rehoboth","92500247",2912,3246,0.472880805456317,-334
"MA","Revere","92500248",11141,5560,0.667085803245315,5581
"MA","Richmond","92500249",688,226,0.7527352297593,462
"MA","Rochester","92500250",1362,1704,0.444227005870841,-342
"MA","Rockland","92500251",4526,3989,0.531532589547857,537
"MA","Rockport","92500252",2982,1670,0.641014617368874,1312
"MA","Rowe","92500253",140,92,0.603448275862069,48
"MA","Rowley","92500254",1596,1935,0.451996601529312,-339
"MA","Royalston","92500255",391,267,0.594224924012158,124
"MA","Russell","92500256",388,386,0.501291989664083,2
"MA","Rutland","92500257",2071,2329,0.470681818181818,-258
"MA","Salem","92500258",13429,5635,0.704416701636593,7794
"MA","Salisbury","92500259",2278,1938,0.540322580645161,340
"MA","Sandisfield","92500260",294,154,0.65625,140
"MA","Sandwich","92500261",5802,6492,0.471937530502684,-690
"MA","Saugus","92500262",6957,6557,0.51479946721918,400
"MA","Savoy","92500263",241,103,0.700581395348837,138
"MA","Scituate","92500264",5528,5659,0.494144989720211,-131
"MA","Seekonk","92500265",3772,3382,0.527257478333799,390
"MA","Sharon","92500266",6558,3659,0.641871390819223,2899
"MA","Sheffield","92500267",1291,503,0.719620958751394,788
"MA","Shelburne","92500268",873,226,0.794358507734304,647
"MA","Sherborn","92500269",1430,1179,0.548102721349176,251
"MA","Shirley","92500270",1553,1482,0.51169686985173,71
"MA","Shrewsbury","92500271",9674,8154,0.542629571460624,1520
"MA","Shutesbury","92500272",1028,156,0.868243243243243,872
"MA","Somerset","92500273",6091,3674,0.623758320532514,2417
"MA","Somerville","92500274",28467,4865,0.854044161766471,23602
"MA","South Hadley","92500278",5362,3252,0.62247504063153,2110
"MA","Southampton","92500275",1861,1584,0.540203193033382,277
"MA","Southborough","92500276",2935,2782,0.513381143956621,153
"MA","Southbridge","92500277",4256,2291,0.650068733771193,1965
"MA","Southwick","92500279",2050,2770,0.425311203319502,-720
"MA","Spencer","92500280",2617,2785,0.484450203628286,-168
"MA","Springfield","92500281",42963,10372,0.805531077153839,32591
"MA","Sterling","92500282",2029,2667,0.432069846678024,-638
"MA","Stockbridge","92500283",944,226,0.806837606837607,718
"MA","Stoneham","92500284",6634,5580,0.543147208121827,1054
"MA","Stoughton","92500285",8119,5591,0.592195477753465,2528
"MA","Stow","92500286",2348,1831,0.561856903565446,517
"MA","Sturbridge","92500287",2514,2615,0.49015402612595,-101
"MA","Sudbury","92500288",6026,4341,0.581267483360664,1685
"MA","Sunderland","92500289",1363,404,0.77136389360498,959
"MA","Sutton","92500290",2181,3087,0.414009111617312,-906
"MA","Swampscott","92500291",4899,3202,0.604740155536354,1697
"MA","Swansea","92500292",4512,3269,0.579874052178383,1243
"MA","Taunton","92500293",13479,8783,0.605471206540293,4696
"MA","Templeton","92500294",1857,1851,0.500809061488673,6
"MA","Tewksbury","92500295",7540,8332,0.475050403225806,-792
"MA","Tisbury","92500296",1845,595,0.756147540983607,1250
"MA","Tolland","92500297",110,155,0.415094339622642,-45
"MA","Topsfield","92500298",1800,2164,0.454086781029263,-364
"MA","Townsend","92500299",2087,2725,0.433707398171239,-638
"MA","Truro","92500300",1041,399,0.722916666666667,642
"MA","Tyngsborough","92500301",2837,3361,0.457728299451436,-524
"MA","Tyringham","92500302",173,85,0.670542635658915,88
"MA","Upton","92500303",1985,2132,0.482147194559145,-147
"MA","Uxbridge","92500304",3325,3728,0.471430596909117,-403
"MA","Wakefield","92500305",7486,6806,0.523789532605654,680
"MA","Wales","92500306",479,434,0.524644030668127,45
"MA","Walpole","92500307",6360,7456,0.460335842501448,-1096
"MA","Waltham","92500308",15748,8816,0.641100797915649,6932
"MA","Ware","92500309",2390,1783,0.572729451234124,607
"MA","Wareham","92500310",6069,4632,0.567143257639473,1437
"MA","Warren","92500311",1219,1002,0.54885186852769,217
"MA","Warwick","92500312",334,109,0.753950338600451,225
"MA","Washington","92500313",239,69,0.775974025974026,170
"MA","Watertown","92500314",11878,4516,0.724533365865561,7362
"MA","Wayland","92500315",5153,2975,0.633981299212598,2178
"MA","Webster","92500316",3476,3111,0.527706087748596,365
"MA","Wellesley","92500317",8243,6144,0.57294780009731,2099
"MA","Wellfleet","92500318",1568,619,0.716963877457705,949
"MA","Wendell","92500319",425,70,0.858585858585859,355
"MA","Wenham","92500320",1058,1265,0.455445544554455,-207
"MA","West Boylston","92500322",2029,2083,0.493433852140078,-54
"MA","West Bridgewater","92500323",1734,2169,0.444273635664873,-435
"MA","West Brookfield","92500324",964,950,0.503657262277952,14
"MA","West Newbury","92500329",1383,1347,0.506593406593407,36
"MA","West Springfield","92500332",6170,5169,0.544139694858453,1001
"MA","West Stockbridge","92500333",707,161,0.814516129032258,546
"MA","West Tisbury","92500334",1571,371,0.808959835221421,1200
"MA","Westborough","92500321",4999,3818,0.566972893274356,1181
"MA","Westfield","92500325",9228,8178,0.530162013098931,1050
"MA","Westford","92500326",6385,6295,0.503548895899054,90
"MA","Westhampton","92500327",639,385,0.6240234375,254
"MA","Westminster","92500328",1940,2245,0.463560334528076,-305
"MA","Weston","92500330",3390,3159,0.517636280348145,231
"MA","Westport","92500331",5074,3372,0.600757755150367,1702
"MA","Westwood","92500335",4337,4549,0.488071123115012,-212
"MA","Weymouth","92500336",15130,12341,0.550762622401806,2789
"MA","Whately","92500337",626,301,0.67529665587918,325
"MA","Whitman","92500338",3654,3652,0.500136873802354,2
"MA","Wilbraham","92500339",3745,4332,0.463662250835706,-587
"MA","Williamsburg","92500340",1239,324,0.792706333973129,915
"MA","Williamstown","92500341",3012,640,0.824753559693319,2372
"MA","Wilmington","92500342",5890,6437,0.477812930964549,-547
"MA","Winchendon","92500343",2142,1933,0.525644171779141,209
"MA","Winchester","92500344",7000,5602,0.555467386129186,1398
"MA","Windsor","92500345",385,127,0.751953125,258
"MA","Winthrop","92500346",5211,3575,0.593102663328022,1636
"MA","Woburn","92500347",10291,8707,0.541688598799874,1584
"MA","Worcester","92500348",40568,17155,0.702804774526618,23413
"MA","Worthington","92500349",481,208,0.69811320754717,273
"MA","Wrentham","92500350",2704,3535,0.433402788908479,-831
"MA","Yarmouth","92500351",7183,6526,0.523962360493107,657
"MD","Allegany","24001",9001,18158,0.331418682572996,-9157
"MD","Anne Arundel","24003",115960,118165,0.495290977042178,-2205
"MD","Baltimore","24005",202733,144686,0.58354033602077,58047
"MD","Baltimore City","24510",201042,25501,0.887434173644739,175541
"MD","Calvert","24009",18963,22413,0.458309164733179,-3450
"MD","Caroline","24011",4621,7674,0.375843838958926,-3053
"MD","Carroll","24013",26067,53960,0.325727566946156,-27893
"MD","Cecil","24015",15489,23660,0.395642289713658,-8171
"MD","Charles","24017",45621,23637,0.65871090704323,21984
"MD","Dorchester","24019",6570,7514,0.466486793524567,-944
"MD","Frederick","24021",51187,55495,0.479809152434338,-4308
"MD","Garrett","24023",2792,9102,0.234740205145451,-6310
"MD","Harford","24025",46390,69496,0.400307198453653,-23106
"MD","Howard","24027",84017,54094,0.608329532043067,29923
"MD","Kent","24029",4453,4533,0.495548631204095,-80
"MD","Montgomery","24031",286493,110940,0.720858610130513,175553
"MD","Prince George's","24033",317342,32236,0.907785959070651,285106
"MD","Queen Anne's","24035",7898,14879,0.346753303771348,-6981
"MD","Somerset","24039",4478,4706,0.487587108013937,-228
"MD","St. Mary's","24037",17982,25096,0.417428849993036,-7114
"MD","Talbot","24041",7983,10442,0.433270013568521,-2459
"MD","Washington","24043",23282,34113,0.405645091035805,-10831
"MD","Wicomico","24045",17481,20136,0.464710104474041,-2655
"MD","Worcester","24047",9841,14334,0.407073422957601,-4493
"ME","Abbot","92300001",153,216,0.414634146341463,-63
"ME","Acton","92300002",688,625,0.523990860624524,63
"ME","Addison","92300003",273,299,0.477272727272727,-26
"ME","Albion","92300005",429,561,0.433333333333333,-132
"ME","Alexander","92300006",131,153,0.461267605633803,-22
"ME","Alfred","92300007",964,739,0.566059894304169,225
"ME","Allagash","92300008",79,59,0.572463768115942,20
"ME","Alna","92300009",271,182,0.598233995584989,89
"ME","Alton","92300010",225,211,0.51605504587156,14
"ME","Amherst","92300011",69,70,0.496402877697842,-1
"ME","Amity","92300012",35,56,0.384615384615385,-21
"ME","Andover","92300013",255,217,0.540254237288136,38
"ME","Anson","92300014",543,512,0.514691943127962,31
"ME","Appleton","92300015",435,329,0.569371727748691,106
"ME","Aroostook Cty Townships","92300528",182,185,0.49591280653951,-3
"ME","Arrowsic","92300016",220,92,0.705128205128205,128
"ME","Arundel","92300017",1229,960,0.561443581544084,269
"ME","Ashland","92300018",327,232,0.584973166368515,95
"ME","Athens","92300019",211,204,0.508433734939759,7
"ME","Atkinson","92300020",73,103,0.414772727272727,-30
"ME","Auburn","92300021",6503,4462,0.593068855449156,2041
"ME","Augusta","92300022",5192,3339,0.608603915133044,1853
"ME","Aurora","92300023",18,42,0.3,-24
"ME","Avon","92300024",127,105,0.547413793103448,22
"ME","Baileyville","92300025",354,230,0.606164383561644,124
"ME","Baldwin","92300026",354,413,0.461538461538462,-59
"ME","Bancroft","92300027",11,20,0.354838709677419,-9
"ME","Bangor","92300028",8809,5905,0.598681527796656,2904
"ME","Bar Harbor","92300029",2142,779,0.733310510099281,1363
"ME","Baring Plt.","92300030",56,49,0.533333333333333,7
"ME","Bath","92300031",2895,1512,0.656909462219197,1383
"ME","Beals","92300032",134,137,0.494464944649447,-3
"ME","Beaver Cove","92300033",41,52,0.440860215053763,-11
"ME","Beddington","92300034",13,21,0.382352941176471,-8
"ME","Belfast","92300035",2270,1240,0.646723646723647,1030
"ME","Belgrade","92300036",952,890,0.516829533116178,62
"ME","Belmont","92300037",261,214,0.549473684210526,47
"ME","Benton","92300039",731,673,0.520655270655271,58
"ME","Berwick","92300040",1733,1812,0.48885754583921,-79
"ME","Bethel","92300041",911,552,0.622693096377307,359
"ME","Biddeford","92300042",6618,3047,0.68473874806001,3571
"ME","Bingham","92300043",248,203,0.549889135254989,45
"ME","Blaine","92300044",99,258,0.277310924369748,-159
"ME","Blue Hill","92300045",1125,588,0.656742556917688,537
"ME","Boothbay","92300046",1082,907,0.543991955756662,175
"ME","Boothbay Harbor","92300047",754,572,0.568627450980392,182
"ME","Bowdoin","92300048",711,837,0.459302325581395,-126
"ME","Bowdoinham","92300049",1020,691,0.59614260666277,329
"ME","Bowerbank","92300050",36,48,0.428571428571429,-12
"ME","Bradford","92300051",251,349,0.418333333333333,-98
"ME","Bradley","92300052",439,345,0.559948979591837,94
"ME","Bremen","92300053",293,187,0.610416666666667,106
"ME","Brewer","92300054",2450,2542,0.490785256410256,-92
"ME","Bridgewater","92300055",111,175,0.388111888111888,-64
"ME","Bridgton","92300056",1501,1199,0.555925925925926,302
"ME","Brighton Plt.","92300057",19,23,0.452380952380952,-4
"ME","Bristol","92300058",1049,718,0.593661573288059,331
"ME","Brooklin","92300059",368,194,0.654804270462633,174
"ME","Brooks","92300060",243,260,0.483101391650099,-17
"ME","Brooksville","92300061",418,210,0.665605095541401,208
"ME","Brownfield","92300063",255,204,0.555555555555556,51
"ME","Brownville","92300064",346,345,0.500723589001447,1
"ME","Brunswick","92300065",7853,3654,0.682454158338403,4199
"ME","Buckfield","92300066",518,465,0.526958290946083,53
"ME","Bucksport","92300067",1358,1024,0.570109151973132,334
"ME","Burlington","92300068",69,115,0.375,-46
"ME","Burnham","92300069",290,292,0.498281786941581,-2
"ME","Buxton","92300070",2212,1909,0.536762921620966,303
"ME","Byron","92300071",39,37,0.513157894736842,2
"ME","Calais","92300072",730,725,0.501718213058419,5
"ME","Cambridge","92300073",96,165,0.367816091954023,-69
"ME","Camden","92300074",2201,914,0.706581059390048,1287
"ME","Canaan","92300075",515,464,0.526046986721144,51
"ME","Canton","92300076",260,197,0.568927789934354,63
"ME","Cape Elizabeth","92300077",4018,2161,0.650267033500566,1857
"ME","Caratunk","92300078",23,28,0.450980392156863,-5
"ME","Caribou","92300079",1910,1665,0.534265734265734,245
"ME","Carmel","92300080",578,849,0.405045550105116,-271
"ME","Carrabassett Valley","92300081",295,153,0.658482142857143,142
"ME","Carroll Plt.","92300082",29,52,0.358024691358025,-23
"ME","Carthage","92300083",139,96,0.591489361702128,43
"ME","Cary Plt.","92300084",39,68,0.364485981308411,-29
"ME","Casco","92300085",993,899,0.524841437632135,94
"ME","Castine","92300086",338,241,0.583765112262522,97
"ME","Castle Hill","92300087",76,118,0.391752577319588,-42
"ME","Caswell","92300088",90,45,0.666666666666667,45
"ME","Chapman","92300090",119,96,0.553488372093023,23
"ME","Charleston","92300091",186,454,0.290625,-268
"ME","Charlotte","92300092",64,97,0.397515527950311,-33
"ME","Chebeague Island","92300521",216,71,0.752613240418119,145
"ME","Chelsea","92300093",693,604,0.534309946029298,89
"ME","Cherryfield","92300094",278,303,0.478485370051635,-25
"ME","Chester","92300095",114,202,0.360759493670886,-88
"ME","Chesterville","92300096",399,246,0.618604651162791,153
"ME","China","92300097",1121,1113,0.501790510295434,8
"ME","Clifton","92300098",221,231,0.488938053097345,-10
"ME","Clinton","92300099",817,730,0.528118939883646,87
"ME","Columbia","92300101",67,126,0.347150259067358,-59
"ME","Columbia Falls","92300102",122,148,0.451851851851852,-26
"ME","Cooper","92300104",57,67,0.459677419354839,-10
"ME","Coplin Plt.","92300105",42,40,0.51219512195122,2
"ME","Corinna","92300106",414,648,0.389830508474576,-234
"ME","Corinth","92300107",477,874,0.353071798667654,-397
"ME","Cornish","92300108",415,324,0.561569688768606,91
"ME","Cornville","92300109",304,358,0.459214501510574,-54
"ME","Cranberry Isles","92300110",102,41,0.713286713286713,61
"ME","Crawford","92300111",23,40,0.365079365079365,-17
"ME","Crystal","92300112",51,86,0.372262773722628,-35
"ME","Cumberland","92300113",2619,2221,0.541115702479339,398
"ME","Cushing","92300114",422,387,0.521631644004944,35
"ME","Cutler","92300115",116,163,0.415770609318996,-47
"ME","Cyr Plt.","92300116",23,20,0.534883720930233,3
"ME","Dallas Plt.","92300117",127,97,0.566964285714286,30
"ME","Damariscotta","92300118",771,503,0.605180533751962,268
"ME","Danforth","92300119",110,150,0.423076923076923,-40
"ME","Dayton","92300120",590,503,0.539798719121683,87
"ME","Deblois","92300121",7,20,0.259259259259259,-13
"ME","Dedham","92300122",534,487,0.523016650342801,47
"ME","Deer Isle","92300123",826,361,0.695871946082561,465
"ME","Denmark","92300124",318,317,0.500787401574803,1
"ME","Dennistown Plt.","92300125",5,9,0.357142857142857,-4
"ME","Dennysville","92300126",77,77,0.5,0
"ME","Detroit","92300127",201,185,0.520725388601036,16
"ME","Dexter","92300128",745,860,0.46417445482866,-115
"ME","Dixfield","92300129",750,470,0.614754098360656,280
"ME","Dixmont","92300130",323,357,0.475,-34
"ME","Dover-Foxcroft","92300131",991,1058,0.48365056124939,-67
"ME","Dresden","92300132",544,412,0.569037656903766,132
"ME","Drew Plt.","92300133",7,13,0.35,-6
"ME","Durham","92300134",1137,1080,0.512855209742896,57
"ME","Dyer Brook","92300135",43,78,0.355371900826446,-35
"ME","Eagle Lake","92300136",276,152,0.644859813084112,124
"ME","East Machias","92300138",310,381,0.44862518089725,-71
"ME","East Millinocket","92300139",483,416,0.53726362625139,67
"ME","Eastbrook","92300137",90,116,0.436893203883495,-26
"ME","Easton","92300140",312,322,0.49211356466877,-10
"ME","Eastport","92300141",488,296,0.622448979591837,192
"ME","Eddington","92300142",557,682,0.44955609362389,-125
"ME","Edgecomb","92300143",418,317,0.568707482993197,101
"ME","Edinburg","92300144",52,42,0.553191489361702,10
"ME","Eliot","92300146",2210,1644,0.57343020238713,566
"ME","Ellsworth","92300147",1950,1843,0.514104930134458,107
"ME","Embden","92300148",218,248,0.467811158798283,-30
"ME","Enfield","92300149",356,389,0.477852348993289,-33
"ME","Etna","92300150",256,344,0.426666666666667,-88
"ME","Eustis","92300151",191,166,0.535014005602241,25
"ME","Exeter","92300152",220,312,0.413533834586466,-92
"ME","Fairfield","92300153",1714,1359,0.557761145460462,355
"ME","Falmouth","92300154",4149,3319,0.555570433851098,830
"ME","Farmingdale","92300155",887,678,0.566773162939297,209
"ME","Farmington","92300156",2441,1288,0.654599088227407,1153
"ME","Fayette","92300157",432,294,0.59504132231405,138
"ME","Fort Fairfield","92300158",821,698,0.540487162606978,123
"ME","Fort Kent","92300159",1376,625,0.687656171914043,751
"ME","Frankfort","92300160",242,270,0.47265625,-28
"ME","Franklin","92300161",354,360,0.495798319327731,-6
"ME","Franklin Cty Townships","92300529",14,8,0.636363636363636,6
"ME","Freedom","92300162",215,163,0.568783068783069,52
"ME","Freeport","92300163",3266,1726,0.654246794871795,1540
"ME","Frenchboro","92300164",21,15,0.583333333333333,6
"ME","Frenchville","92300165",406,164,0.712280701754386,242
"ME","Friendship","92300166",321,360,0.47136563876652,-39
"ME","Frye Island","92300514",17,38,0.309090909090909,-21
"ME","Fryeburg","92300167",920,649,0.58636073932441,271
"ME","Gardiner","92300168",1699,1158,0.594679733986699,541
"ME","Garfield Plt.","92300169",24,27,0.470588235294118,-3
"ME","Garland","92300170",246,287,0.461538461538462,-41
"ME","Georgetown","92300171",447,273,0.620833333333333,174
"ME","Gilead","92300172",68,41,0.623853211009174,27
"ME","Glenburn","92300173",1136,1281,0.470004137360364,-145
"ME","Glenwood Plt.","92300174",2,4,0.333333333333333,-2
"ME","Gorham","92300175",5123,3742,0.577890580936266,1381
"ME","Gouldsboro","92300176",494,460,0.517819706498952,34
"ME","Grand Isle","92300177",174,52,0.769911504424779,122
"ME","Grand Lake Stream Plt","92300178",42,58,0.42,-16
"ME","Gray","92300179",2260,2144,0.513169845594914,116
"ME","Great Pond","92300180",15,19,0.441176470588235,-4
"ME","Greenbush","92300181",253,342,0.425210084033613,-89
"ME","Greene","92300182",1111,1139,0.493777777777778,-28
"ME","Greenville","92300183",599,505,0.542572463768116,94
"ME","Greenwood","92300184",244,172,0.586538461538462,72
"ME","Guilford","92300186",299,357,0.455792682926829,-58
"ME","Hallowell","92300187",1090,426,0.718997361477573,664
"ME","Hamlin","92300188",62,33,0.652631578947368,29
"ME","Hammond","92300189",24,25,0.489795918367347,-1
"ME","Hampden","92300190",2013,2099,0.48954280155642,-86
"ME","Hancock","92300191",596,595,0.500419815281276,1
"ME","Hancock Cty Townships","92300530",0,0,NA,0
"ME","Hanover","92300192",88,71,0.553459119496855,17
"ME","Harmony","92300193",196,245,0.444444444444444,-49
"ME","Harpswell","92300194",1940,1371,0.585925702204772,569
"ME","Harrington","92300195",181,264,0.406741573033708,-83
"ME","Harrison","92300196",737,627,0.540322580645161,110
"ME","Hartford","92300197",307,256,0.545293072824156,51
"ME","Hartland","92300198",324,487,0.399506781750925,-163
"ME","Haynesville","92300199",22,35,0.385964912280702,-13
"ME","Hebron","92300200",370,303,0.549777117384844,67
"ME","Hermon","92300201",1250,1731,0.419322375041932,-481
"ME","Hersey","92300202",9,23,0.28125,-14
"ME","Highland Plt.","92300203",39,62,0.386138613861386,-23
"ME","Hiram","92300204",379,323,0.53988603988604,56
"ME","Hodgdon","92300205",181,377,0.324372759856631,-196
"ME","Holden","92300206",827,1059,0.438494167550371,-232
"ME","Hollis","92300207",1249,1054,0.542336083369518,195
"ME","Hope","92300208",545,381,0.588552915766739,164
"ME","Houlton","92300209",1133,1307,0.464344262295082,-174
"ME","Howland","92300210",342,289,0.541996830427892,53
"ME","Hudson","92300211",278,444,0.385041551246537,-166
"ME","Indian Township Vtng Dst","92300214",208,25,0.892703862660944,183
"ME","Industry","92300215",238,196,0.548387096774194,42
"ME","Island Falls","92300216",189,221,0.460975609756098,-32
"ME","Isle Au Haut","92300217",48,5,0.905660377358491,43
"ME","Islesboro","92300218",282,134,0.677884615384615,148
"ME","Jackman","92300219",190,291,0.395010395010395,-101
"ME","Jackson","92300220",127,137,0.481060606060606,-10
"ME","Jay","92300221",1615,868,0.650422875553766,747
"ME","Jefferson","92300222",676,742,0.47672778561354,-66
"ME","Jonesboro","92300223",140,146,0.48951048951049,-6
"ME","Jonesport","92300224",311,296,0.512355848434926,15
"ME","Kenduskeag","92300225",302,316,0.488673139158576,-14
"ME","Kennebunk","92300226",3935,2798,0.584434873013515,1137
"ME","Kennebunkport","92300227",1323,1073,0.552170283806344,250
"ME","Kingfield","92300228",331,265,0.555369127516778,66
"ME","Kingsbury Plt.","92300230",11,8,0.578947368421053,3
"ME","Kittery","92300231",3443,1814,0.654936275442267,1629
"ME","Knox","92300232",158,226,0.411458333333333,-68
"ME","LaGrange","92300233",139,178,0.438485804416404,-39
"ME","Lake View Plt.","92300234",39,24,0.619047619047619,15
"ME","Lakeville","92300235",37,41,0.474358974358974,-4
"ME","Lamoine","92300236",527,506,0.510164569215876,21
"ME","Lebanon","92300237",1286,1522,0.457977207977208,-236
"ME","Lee","92300238",160,291,0.354767184035477,-131
"ME","Leeds","92300239",609,522,0.538461538461538,87
"ME","Levant","92300240",538,875,0.380750176928521,-337
"ME","Lewiston","92300241",9550,5778,0.623042797494781,3772
"ME","Liberty","92300242",259,219,0.5418410041841,40
"ME","Limerick","92300243",737,646,0.532899493853941,91
"ME","Limestone","92300244",511,324,0.611976047904192,187
"ME","Limington","92300245",908,877,0.508683473389356,31
"ME","Lincoln","92300246",977,1338,0.422030237580994,-361
"ME","Lincoln Plt.","92300247",14,13,0.518518518518518,1
"ME","Lincolnville","92300248",858,535,0.615936826992103,323
"ME","Linneus","92300249",151,282,0.348729792147806,-131
"ME","Lisbon","92300250",2383,2228,0.51680763391889,155
"ME","Litchfield","92300251",919,888,0.50857775318207,31
"ME","Littleton","92300252",171,274,0.384269662921348,-103
"ME","Livermore","92300253",661,518,0.560644614079729,143
"ME","Livermore Falls","92300254",842,467,0.643239113827349,375
"ME","Long Island","92300255",132,60,0.6875,72
"ME","Lovell","92300256",333,306,0.52112676056338,27
"ME","Lowell","92300257",71,119,0.373684210526316,-48
"ME","Lubec","92300258",465,307,0.602331606217617,158
"ME","Ludlow","92300259",100,126,0.442477876106195,-26
"ME","Lyman","92300260",1270,1006,0.557996485061511,264
"ME","Machias","92300261",449,396,0.531360946745562,53
"ME","Machiasport","92300262",243,240,0.503105590062112,3
"ME","Macwahoc Plt.","92300263",18,27,0.4,-9
"ME","Madawaska","92300264",1540,511,0.750853242320819,1029
"ME","Madison","92300266",1118,924,0.547502448579824,194
"ME","Magalloway Plt.","92300268",3,10,0.230769230769231,-7
"ME","Manchester","92300269",831,737,0.529974489795918,94
"ME","Mapleton","92300270",521,531,0.495247148288973,-10
"ME","Mariaville","92300271",123,142,0.464150943396226,-19
"ME","Mars Hill","92300273",276,475,0.367509986684421,-199
"ME","Marshfield","92300272",119,163,0.421985815602837,-44
"ME","Masardis","92300274",90,60,0.6,30
"ME","Matinicus Isle Plt.","92300276",33,18,0.647058823529412,15
"ME","Mattawamkeag","92300277",176,171,0.507204610951009,5
"ME","Maxfield","92300278",22,32,0.407407407407407,-10
"ME","Mechanic Falls","92300279",753,678,0.526205450733753,75
"ME","Meddybemps","92300280",36,50,0.418604651162791,-14
"ME","Medford","92300281",48,80,0.375,-32
"ME","Medway","92300282",285,388,0.423476968796434,-103
"ME","Mercer","92300283",190,164,0.536723163841808,26
"ME","Merrill","92300284",62,64,0.492063492063492,-2
"ME","Mexico","92300285",894,352,0.717495987158908,542
"ME","Milbridge","92300286",320,282,0.53156146179402,38
"ME","Milford","92300287",865,650,0.570957095709571,215
"ME","Millinocket","92300288",1317,937,0.584294587400177,380
"ME","Milo","92300289",506,572,0.469387755102041,-66
"ME","Minot","92300291",704,771,0.47728813559322,-67
"ME","Monhegan Plt.","92300292",49,5,0.907407407407407,44
"ME","Monmouth","92300293",1162,1069,0.520842671447781,93
"ME","Monroe","92300294",265,192,0.579868708971554,73
"ME","Monson","92300295",208,213,0.494061757719715,-5
"ME","Monticello","92300296",158,218,0.420212765957447,-60
"ME","Montville","92300297",319,192,0.62426614481409,127
"ME","Moose River","92300298",33,76,0.302752293577982,-43
"ME","Moro Plt.","92300299",1,21,0.0454545454545455,-20
"ME","Morrill","92300300",217,271,0.444672131147541,-54
"ME","Moscow","92300301",137,110,0.554655870445344,27
"ME","Mount Chase","92300302",36,76,0.321428571428571,-40
"ME","Mount Desert","92300303",911,442,0.673318551367332,469
"ME","Mount Vernon","92300304",517,398,0.565027322404372,119
"ME","Naples","92300305",1057,983,0.518137254901961,74
"ME","Nashville Plt.","92300306",12,6,0.666666666666667,6
"ME","New Canada","92300308",148,101,0.594377510040161,47
"ME","New Gloucester","92300311",1564,1517,0.507627393703343,47
"ME","New Limerick","92300312",134,178,0.429487179487179,-44
"ME","New Portland","92300314",213,194,0.523341523341523,19
"ME","New Sharon","92300316",433,383,0.530637254901961,50
"ME","New Sweden","92300317",182,158,0.535294117647059,24
"ME","New Vineyard","92300318",191,199,0.48974358974359,-8
"ME","Newburgh","92300307",395,428,0.479951397326853,-33
"ME","Newcastle","92300309",744,421,0.63862660944206,323
"ME","Newfield","92300310",406,366,0.525906735751295,40
"ME","Newport","92300313",684,890,0.434561626429479,-206
"ME","Newry","92300315",127,100,0.559471365638767,27
"ME","Nobleboro","92300319",622,466,0.571691176470588,156
"ME","Norridgewock","92300320",772,806,0.489226869455006,-34
"ME","North Berwick","92300321",1361,1266,0.518081461743434,95
"ME","North Haven","92300323",199,67,0.74812030075188,132
"ME","North Yarmouth","92300325",1418,1001,0.586192641587433,417
"ME","Northfield","92300322",47,47,0.5,0
"ME","Northport","92300324",535,398,0.573419078242229,137
"ME","Norway","92300326",1351,1033,0.566694630872483,318
"ME","Oakfield","92300327",145,202,0.417867435158501,-57
"ME","Oakland","92300328",1686,1435,0.540211470682474,251
"ME","Ogunquit","92300329",549,347,0.612723214285714,202
"ME","Old Orchrd Bch","92300330",3247,1804,0.642843001385864,1443
"ME","Old Town","92300331",2366,1358,0.635338345864662,1008
"ME","Orient","92300332",48,42,0.533333333333333,6
"ME","Orland","92300333",717,513,0.582926829268293,204
"ME","Orono","92300335",3761,1396,0.729299980608881,2365
"ME","Orrington","92300336",986,1188,0.453541858325667,-202
"ME","Osborn","92300337",9,31,0.225,-22
"ME","Otis","92300338",144,265,0.352078239608802,-121
"ME","Otisfield","92300339",517,438,0.541361256544503,79
"ME","Owl's Head","92300340",560,403,0.581516095534787,157
"ME","Oxbow Plt.","92300341",80,60,0.571428571428571,20
"ME","Oxford","92300342",1049,918,0.53329944077275,131
"ME","Oxford Cty Townships","92300531",169,94,0.642585551330799,75
"ME","Palermo","92300343",352,429,0.450704225352113,-77
"ME","Palmyra","92300344",430,576,0.427435387673956,-146
"ME","Paris","92300345",1345,1020,0.568710359408034,325
"ME","Parkman","92300346",176,227,0.436724565756824,-51
"ME","Parsonsfield","92300347",471,380,0.553466509988249,91
"ME","Passadumkeag","92300348",70,120,0.368421052631579,-50
"ME","Patten","92300349",223,267,0.455102040816327,-44
"ME","Pembroke","92300350",229,211,0.520454545454546,18
"ME","Penobscot","92300351",356,389,0.477852348993289,-33
"ME","Penobscot Cty Townships","92300532",127,150,0.458483754512635,-23
"ME","Penobscot Nation Vot Dst","92300212",253,23,0.916666666666667,230
"ME","Perham","92300352",58,114,0.337209302325581,-56
"ME","Perry","92300354",219,217,0.502293577981651,2
"ME","Peru","92300355",491,318,0.606922126081582,173
"ME","Phillips","92300356",301,248,0.548269581056466,53
"ME","Phippsburg","92300357",754,607,0.554004408523145,147
"ME","Piscataquis Cty Townshps","92300533",19,38,0.333333333333333,-19
"ME","Pittsfield","92300358",869,941,0.480110497237569,-72
"ME","Pittston","92300359",779,752,0.508817766165905,27
"ME","Pleasant Point Votng Dst","92300360",204,29,0.875536480686695,175
"ME","Pleasant Ridge Plt.","92300361",29,22,0.568627450980392,7
"ME","Plymouth","92300362",265,374,0.41471048513302,-109
"ME","Poland","92300363",1585,1369,0.536560595802302,216
"ME","Portage Lake","92300364",125,109,0.534188034188034,16
"ME","Porter","92300365",371,346,0.517433751743375,25
"ME","Portland","92300366",27736,7487,0.787440024983675,20249
"ME","Pownal","92300367",550,422,0.565843621399177,128
"ME","Presque Isle","92300368",2231,1885,0.542031098153547,346
"ME","Princeton","92300369",196,251,0.438478747203579,-55
"ME","Prospect","92300370",193,150,0.56268221574344,43
"ME","Randolph","92300371",536,385,0.581976112920738,151
"ME","Rangeley","92300372",334,350,0.488304093567251,-16
"ME","Rangeley Plt.","92300373",64,79,0.447552447552448,-15
"ME","Raymond","92300374",1426,1196,0.543859649122807,230
"ME","Readfield","92300375",862,631,0.577361018084394,231
"ME","Reed Plt.","92300376",25,55,0.3125,-30
"ME","Richmond","92300377",952,772,0.552204176334107,180
"ME","Ripley","92300378",93,130,0.417040358744395,-37
"ME","Robbinston","92300379",143,142,0.501754385964912,1
"ME","Rockland","92300380",2198,1065,0.673613239350291,1133
"ME","Rockport","92300381",1291,825,0.610113421550095,466
"ME","Rome","92300383",314,248,0.558718861209964,66
"ME","Roque Bluffs","92300384",92,60,0.605263157894737,32
"ME","Roxbury","92300385",151,91,0.62396694214876,60
"ME","Rumford","92300386",1671,915,0.646171693735499,756
"ME","Sabattus","92300387",1294,1160,0.527302363488183,134
"ME","Saco","92300388",6146,3556,0.633477633477634,2590
"ME","Saint Agatha","92300389",399,161,0.7125,238
"ME","Sandy River Plt.","92300394",52,33,0.611764705882353,19
"ME","Sanford","92300395",5588,3701,0.601571751534073,1887
"ME","Sangerville","92300396",317,341,0.481762917933131,-24
"ME","Scarborough","92300397",6343,5184,0.55027327144964,1159
"ME","Searsmont","92300398",383,333,0.534916201117318,50
"ME","Searsport","92300399",767,622,0.552195824334053,145
"ME","Sebago","92300400",516,472,0.522267206477733,44
"ME","Sebec","92300401",139,225,0.381868131868132,-86
"ME","Seboeis Plt.","92300402",16,10,0.615384615384615,6
"ME","Sedgwick","92300403",447,233,0.657352941176471,214
"ME","Shapleigh","92300404",720,693,0.509554140127389,27
"ME","Sherman","92300405",218,365,0.373927958833619,-147
"ME","Shirley","92300406",55,77,0.416666666666667,-22
"ME","Sidney","92300407",1120,1134,0.496894409937888,-14
"ME","Skowhegan","92300409",2225,1558,0.588157546920434,667
"ME","Smithfield","92300410",282,272,0.509025270758123,10
"ME","Smyrna","92300411",55,67,0.450819672131148,-12
"ME","Solon","92300412",268,266,0.50187265917603,2
"ME","Somerset Cty Townships","92300534",71,121,0.369791666666667,-50
"ME","Somerville","92300413",136,129,0.513207547169811,7
"ME","Sorrento","92300414",104,77,0.574585635359116,27
"ME","South Berwick","92300415",2276,1626,0.583290620194772,650
"ME","South Bristol","92300416",376,224,0.626666666666667,152
"ME","South Portland","92300418",9956,4104,0.708108108108108,5852
"ME","South Thomaston","92300419",507,346,0.594372801875733,161
"ME","Southport","92300417",207,223,0.481395348837209,-16
"ME","Southwest Harbor","92300420",653,380,0.632139399806389,273
"ME","Springfield","92300421",52,101,0.339869281045752,-49
"ME","St. Albans","92300390",416,620,0.401544401544402,-204
"ME","St. Francis","92300391",172,76,0.693548387096774,96
"ME","St. George","92300392",980,518,0.654205607476635,462
"ME","St. John Plt.","92300393",80,56,0.588235294117647,24
"ME","Stacyville","92300422",72,135,0.347826086956522,-63
"ME","Standish","92300423",2554,2400,0.515542995559144,154
"ME","Starks","92300424",171,133,0.5625,38
"ME","Stetson","92300425",294,352,0.455108359133127,-58
"ME","Steuben","92300426",257,269,0.488593155893536,-12
"ME","Stockholm","92300427",91,53,0.631944444444444,38
"ME","Stockton Springs","92300428",491,424,0.536612021857923,67
"ME","Stoneham","92300429",90,59,0.604026845637584,31
"ME","Stonington","92300430",407,184,0.688663282571912,223
"ME","Stow","92300431",122,63,0.659459459459459,59
"ME","Strong","92300432",337,347,0.492690058479532,-10
"ME","Sullivan","92300433",352,227,0.607944732297064,125
"ME","Sumner","92300434",271,241,0.529296875,30
"ME","Surry","92300435",538,395,0.576634512325831,143
"ME","Swan's Island","92300436",94,124,0.431192660550459,-30
"ME","Swanville","92300437",362,295,0.550989345509893,67
"ME","Sweden","92300438",125,96,0.565610859728507,29
"ME","Talmadge","92300441",13,19,0.40625,-6
"ME","Temple","92300442",216,94,0.696774193548387,122
"ME","The Forks Plt.","92300443",23,21,0.522727272727273,2
"ME","Thomaston","92300444",860,522,0.622286541244573,338
"ME","Thorndike","92300445",214,154,0.581521739130435,60
"ME","Topsfield","92300446",38,73,0.342342342342342,-35
"ME","Topsham","92300447",3153,2259,0.582594235033259,894
"ME","Tremont","92300450",550,306,0.642523364485981,244
"ME","Trenton","92300451",436,340,0.561855670103093,96
"ME","Troy","92300452",258,260,0.498069498069498,-2
"ME","Turner","92300453",1429,1585,0.474120769741208,-156
"ME","Union","92300454",712,598,0.543511450381679,114
"ME","Unity","92300455",479,443,0.519522776572668,36
"ME","Upton","92300456",0,0,NA,0
"ME","Van Buren","92300457",684,210,0.76510067114094,474
"ME","Vanceboro","92300458",51,52,0.495145631067961,-1
"ME","Vassalboro","92300459",1224,1025,0.544241885282348,199
"ME","Veazie","92300460",580,482,0.546139359698682,98
"ME","Verona","92300461",166,138,0.546052631578947,28
"ME","Vienna","92300462",205,136,0.601173020527859,69
"ME","Vinalhaven","92300463",519,177,0.745689655172414,342
"ME","Wade","92300464",50,74,0.403225806451613,-24
"ME","Waite","92300465",22,33,0.4,-11
"ME","Waldo","92300466",225,184,0.550122249388753,41
"ME","Waldoboro","92300467",1323,1164,0.531966224366707,159
"ME","Wales","92300468",351,453,0.436567164179104,-102
"ME","Wallagrass","92300469",204,77,0.725978647686833,127
"ME","Waltham","92300470",69,116,0.372972972972973,-47
"ME","Warren","92300471",966,945,0.505494505494505,21
"ME","Washburn","92300472",346,418,0.452879581151832,-72
"ME","Washington","92300473",430,402,0.516826923076923,28
"ME","Washington Cty Townships","92300535",104,173,0.375451263537906,-69
"ME","Waterboro","92300474",1848,1581,0.538932633420822,267
"ME","Waterford","92300475",455,382,0.543608124253286,73
"ME","Waterville","92300476",4677,2103,0.689823008849557,2574
"ME","Wayne","92300477",450,273,0.622406639004149,177
"ME","Webster Plt.","92300478",13,9,0.590909090909091,4
"ME","Weld","92300479",154,123,0.555956678700361,31
"ME","Wellington","92300480",80,40,0.666666666666667,40
"ME","Wells","92300481",3182,2612,0.549188816016569,570
"ME","Wesley","92300482",32,44,0.421052631578947,-12
"ME","West Bath","92300483",641,544,0.540928270042194,97
"ME","West Forks Plt.","92300486",25,21,0.543478260869565,4
"ME","West Gardiner","92300487",1004,971,0.508354430379747,33
"ME","West Paris","92300490",470,353,0.571081409477521,117
"ME","Westbrook","92300484",5504,3042,0.644043997191669,2462
"ME","Westfield","92300485",117,146,0.444866920152091,-29
"ME","Westmanland","92300488",21,21,0.5,0
"ME","Weston","92300489",50,81,0.381679389312977,-31
"ME","Westport","92300491",254,221,0.534736842105263,33
"ME","Whitefield","92300492",693,531,0.566176470588235,162
"ME","Whiting","92300493",178,154,0.536144578313253,24
"ME","Whitneyville","92300494",48,56,0.461538461538462,-8
"ME","Willimantic","92300495",32,48,0.4,-16
"ME","Wilton","92300496",1251,921,0.575966850828729,330
"ME","Windham","92300497",3817,3427,0.526918829376035,390
"ME","Windsor","92300498",610,578,0.513468013468014,32
"ME","Winn","92300499",66,112,0.370786516853933,-46
"ME","Winslow","92300500",2206,1781,0.55329821921244,425
"ME","Winter Harbor","92300501",112,145,0.43579766536965,-33
"ME","Winterport","92300502",1027,1018,0.502200488997555,9
"ME","Winterville Plt.","92300503",79,49,0.6171875,30
"ME","Winthrop","92300504",1877,1496,0.556477912837237,381
"ME","Wiscasset","92300505",1036,960,0.519038076152305,76
"ME","Woodland","92300506",285,326,0.466448445171849,-41
"ME","Woodstock","92300507",351,344,0.505035971223022,7
"ME","Woodville","92300508",62,61,0.504065040650406,1
"ME","Woolwich","92300509",1028,842,0.549732620320856,186
"ME","Yarmouth","92300510",3358,2128,0.612103536274152,1230
"ME","York","92300511",4888,3594,0.576279179438812,1294
"MI","Alcona","26001",2462,3571,0.408088844687552,-1109
"MI","Alger","26003",2212,2329,0.487117375027527,-117
"MI","Allegan","26005",19594,29023,0.403027747495732,-9429
"MI","Alpena","26007",6549,7298,0.472954430562577,-749
"MI","Antrim","26009",5107,7917,0.392122235872236,-2810
"MI","Arenac","26011",3669,4054,0.475074452932798,-385
"MI","Baraga","26013",1574,1866,0.457558139534884,-292
"MI","Barry","26015",11496,16651,0.408427185845738,-5155
"MI","Bay","26017",26797,23735,0.530297633182934,3062
"MI","Benzie","26019",4683,5071,0.480110723805618,-388
"MI","Berrien","26021",33465,38209,0.466905711973658,-4744
"MI","Branch","26023",6526,9575,0.405316439972673,-3049
"MI","Calhoun","26025",29270,28338,0.508089154284127,932
"MI","Cass","26027",9587,12660,0.430934508023554,-3073
"MI","Charlevoix","26029",5936,7997,0.426038900452164,-2061
"MI","Cheboygan","26031",5829,7284,0.444520704644246,-1455
"MI","Chippewa","26033",7100,8278,0.461698530368058,-1178
"MI","Clare","26035",6337,6988,0.475572232645403,-651
"MI","Clinton","26037",18187,20630,0.46853182883788,-2443
"MI","Crawford","26039",2994,3744,0.444345503116652,-750
"MI","Delta","26041",8330,9533,0.466327044729329,-1203
"MI","Dickinson","26043",4952,7688,0.391772151898734,-2736
"MI","Eaton","26045",27912,26193,0.515885777654561,1719
"MI","Emmet","26047",7225,10253,0.413376816569402,-3028
"MI","Genesee","26049",128972,71807,0.642358015529513,57165
"MI","Gladwin","26051",5760,6661,0.463730778520248,-901
"MI","Gogebic","26053",4058,3444,0.540922420687817,614
"MI","Grand Traverse","26055",20875,26532,0.440335815385913,-5657
"MI","Gratiot","26057",7606,8236,0.480116146951143,-630
"MI","Hillsdale","26059",7106,11727,0.37731641267987,-4621
"MI","Houghton","26061",6530,8040,0.448181194234729,-1510
"MI","Huron","26063",6432,8686,0.425453102262204,-2254
"MI","Ingham","26065",80903,45365,0.640724490765673,35538
"MI","Ionia","26067",11016,14319,0.434813499111901,-3303
"MI","Iosco","26069",6242,6906,0.474749011256465,-664
"MI","Iron","26071",2687,3224,0.454576213838606,-537
"MI","Isabella","26073",13038,10800,0.546941857538384,2238
"MI","Jackson","26075",32301,36298,0.470866922258342,-3997
"MI","Kalamazoo","26077",69045,52660,0.567314407789327,16385
"MI","Kalkaska","26079",3268,4897,0.400244947948561,-1629
"MI","Kent","26081",134560,157801,0.460252906509418,-23241
"MI","Keweenaw","26083",582,774,0.429203539823009,-192
"MI","Lake","26085",2752,2487,0.525291086085131,265
"MI","Lapeer","26087",18786,23725,0.441909152925125,-4939
"MI","Leelanau","26089",6576,7483,0.467743082722811,-907
"MI","Lenawee","26091",21774,22351,0.493461756373938,-577
"MI","Livingston","26093",37186,60000,0.382627127364024,-22814
"MI","Luce","26095",951,1501,0.387846655791191,-550
"MI","Mackinac","26097",2652,3396,0.438492063492063,-744
"MI","Macomb","26099",207992,191896,0.52012563517785,16096
"MI","Manistee","26101",6467,5736,0.529951651233303,731
"MI","Marquette","26103",18126,13609,0.571167480699543,4517
"MI","Mason","26105",6856,7580,0.474923801607093,-724
"MI","Mecosta","26107",7515,9175,0.45026962252846,-1660
"MI","Menominee","26109",5244,5565,0.485151262836525,-321
"MI","Midland","26111",17480,23942,0.421997972092125,-6462
"MI","Missaukee","26113",2274,4665,0.327712926934717,-2391
"MI","Monroe","26115",36310,35593,0.504985883760066,717
"MI","Montcalm","26117",11431,13624,0.456236280183596,-2193
"MI","Montmorency","26119",2049,2928,0.411693791440627,-879
"MI","Muskegon","26121",44436,30882,0.589978491197323,13554
"MI","Newaygo","26123",8723,12458,0.41183135829281,-3735
"MI","Oakland","26125",349055,296531,0.540679320803115,52524
"MI","Oceana","26127",5063,6239,0.447973809945142,-1176
"MI","Ogemaw","26129",4791,5437,0.468420023464998,-646
"MI","Ontonagon","26131",1585,1906,0.454024634775136,-321
"MI","Osceola","26133",3981,6140,0.393340578994171,-2159
"MI","Oscoda","26135",1654,2308,0.417465926299849,-654
"MI","Otsego","26137",4681,7008,0.400461972794935,-2327
"MI","Ottawa","26139",43068,88503,0.327336571128896,-45435
"MI","Presque Isle","26141",3192,3794,0.456913827655311,-602
"MI","Roscommon","26143",6198,6701,0.480502364524382,-503
"MI","Saginaw","26145",54372,42716,0.560028015820699,11656
"MI","Sanilac","26151",7212,10961,0.396852473449623,-3749
"MI","Schoolcraft","26153",1865,2142,0.465435487896182,-277
"MI","Shiawassee","26155",17197,15962,0.518622395126512,1235
"MI","St. Clair","26147",33845,39076,0.464132417273488,-5231
"MI","St. Joseph","26149",10106,12975,0.437849313287986,-2869
"MI","Tuscola","26157",11643,14517,0.44506880733945,-2874
"MI","Van Buren","26159",16288,16140,0.502281978537067,148
"MI","Washtenaw","26161",120791,56401,0.681695561876383,64390
"MI","Wayne","26163",595253,213586,0.735935087205241,381667
"MI","Wexford","26165",5717,7972,0.417634597121777,-2255
"MN","Aitkin","27001",4412,4533,0.493236444941308,-121
"MN","Anoka","27003",88611,93430,0.486763970753841,-4819
"MN","Becker","27005",6829,9204,0.425934011102102,-2375
"MN","Beltrami","27007",11818,9637,0.550827312980657,2181
"MN","Benton","27009",8173,10849,0.429660393228893,-2676
"MN","Big Stone","27011",1345,1385,0.492673992673993,-40
"MN","Blue Earth","27013",18164,14916,0.549093107617896,3248
"MN","Brown","27015",5630,7938,0.414946933962264,-2308
"MN","Carlton","27017",11389,6586,0.633602225312935,4803
"MN","Carver","27019",20745,31155,0.39971098265896,-10410
"MN","Cass","27021",6858,8957,0.433638950363579,-2099
"MN","Chippewa","27023",3083,2967,0.509586776859504,116
"MN","Chisago","27025",12524,16227,0.43560223992209,-3703
"MN","Clay","27027",15210,12920,0.54070387486669,2290
"MN","Clearwater","27029",1753,2359,0.426313229571984,-606
"MN","Cook","27031",1993,1221,0.620099564405725,772
"MN","Cottonwood","27033",2433,3316,0.423204035484432,-883
"MN","Crow Wing","27035",14760,19415,0.431894659839064,-4655
"MN","Dakota","27037",116252,109514,0.51492253040759,6738
"MN","Dodge","27039",4487,5522,0.448296533120192,-1035
"MN","Douglas","27041",8665,11905,0.421244530870199,-3240
"MN","Faribault","27043",3407,4104,0.453601384635867,-697
"MN","Fillmore","27045",5713,4913,0.537643515904385,800
"MN","Freeborn","27047",9327,6970,0.572313922807879,2357
"MN","Goodhue","27049",12212,12986,0.484641638225256,-774
"MN","Grant","27051",1647,1748,0.485125184094256,-101
"MN","Hennepin","27053",423979,240073,0.638472589496003,183906
"MN","Houston","27055",5281,4951,0.516125879593432,330
"MN","Hubbard","27057",4676,6622,0.413878562577447,-1946
"MN","Isanti","27059",8024,11675,0.407330321336108,-3651
"MN","Itasca","27061",12852,10500,0.550359712230216,2352
"MN","Jackson","27063",2268,3044,0.426957831325301,-776
"MN","Kanabec","27065",3586,4319,0.453636938646426,-733
"MN","Kandiyohi","27067",9806,11239,0.465953908291756,-1433
"MN","Kittson","27069",1241,1095,0.53125,146
"MN","Koochiching","27071",3451,2841,0.548474253019708,610
"MN","Lac Qui Parle","27073",1974,1938,0.504601226993865,36
"MN","Lake","27075",4043,2610,0.6076957763415,1433
"MN","Lake of the Woods","27077",859,1306,0.396766743648961,-447
"MN","Le Sueur","27079",6753,7714,0.466786479574203,-961
"MN","Lincoln","27081",1428,1594,0.472534745201853,-166
"MN","Lyon","27083",5465,6595,0.453150912106136,-1130
"MN","Mahnomen","27087",1276,871,0.594317652538426,405
"MN","Marshall","27089",1854,2380,0.437883797827114,-526
"MN","Martin","27091",4054,6657,0.378489403417048,-2603
"MN","McLeod","27085",6970,11069,0.386385054603914,-4099
"MN","Meeker","27093",4969,6913,0.418195589968019,-1944
"MN","Mille Lacs","27095",5829,6951,0.456103286384977,-1122
"MN","Morrison","27097",6153,10159,0.377206964198136,-4006
"MN","Mower","27099",11129,6938,0.615984944927215,4191
"MN","Murray","27101",2160,2504,0.463121783876501,-344
"MN","Nicollet","27103",9652,8214,0.540244038956677,1438
"MN","Nobles","27105",3793,4581,0.452949605923095,-788
"MN","Norman","27107",1730,1384,0.555555555555556,346
"MN","Olmsted","27109",39338,36832,0.516450045949849,2506
"MN","Otter Tail","27111",12165,18860,0.392103142626914,-6695
"MN","Pennington","27113",3024,3304,0.47787610619469,-280
"MN","Pine","27115",6750,6845,0.496506068407503,-95
"MN","Pipestone","27117",1728,2828,0.37928007023705,-1100
"MN","Polk","27119",6773,7615,0.470739505143175,-842
"MN","Pope","27121",2981,3142,0.486852849910175,-161
"MN","Ramsey","27123",184936,86799,0.680574824737336,98137
"MN","Red Lake","27125",928,978,0.48688352570829,-50
"MN","Redwood","27127",3008,4570,0.396938506202164,-1562
"MN","Renville","27129",3394,4149,0.449953599363648,-755
"MN","Rice","27131",17054,14380,0.542533562384679,2674
"MN","Rock","27133",1945,2810,0.409043112513144,-865
"MN","Roseau","27135",2772,4409,0.386018660353711,-1637
"MN","Scott","27139",29714,40321,0.424273577496966,-10607
"MN","Sherburne","27141",17597,27848,0.387215315216195,-10251
"MN","Sibley","27143",2916,4693,0.383230385070311,-1777
"MN","St. Louis","27137",74177,39675,0.651521273231915,34502
"MN","Stearns","27145",33552,43015,0.438204448391605,-9463
"MN","Steele","27147",8706,9903,0.467838142834113,-1197
"MN","Stevens","27149",2742,2766,0.497821350762527,-24
"MN","Swift","27151",2751,2248,0.550310062012403,503
"MN","Todd","27153",4819,6719,0.417663373201595,-1900
"MN","Traverse","27155",942,860,0.522752497225305,82
"MN","Wabasha","27157",5415,6049,0.472348220516399,-634
"MN","Wadena","27159",2492,4143,0.375584024114544,-1651
"MN","Waseca","27161",4370,5116,0.460678895214,-746
"MN","Washington","27163",70203,69137,0.503825175828908,1066
"MN","Watonwan","27165",2494,2517,0.497705048892437,-23
"MN","Wilkin","27167",1258,1884,0.400381922342457,-626
"MN","Winona","27169",14980,11480,0.566137566137566,3500
"MN","Wright","27171",26584,41460,0.390688378108283,-14876
"MN","Yellow Medicine","27173",2465,2806,0.467653196736862,-341
"MO","Adair","29001",4218,5648,0.427528887086965,-1430
"MO","Andrew","29003",2649,5457,0.32679496669134,-2808
"MO","Atchison","29005",756,1902,0.284424379232506,-1146
"MO","Audrain","29007",3538,6186,0.363842040312629,-2648
"MO","Barry","29009",3667,9832,0.271649751833469,-6165
"MO","Barton","29011",1232,4416,0.218130311614731,-3184
"MO","Bates","29013",2557,5020,0.337468655140557,-2463
"MO","Benton","29015",2925,6069,0.325216811207472,-3144
"MO","Bollinger","29017",1213,4094,0.228566044846429,-2881
"MO","Boone","29019",39782,37343,0.515811993517018,2439
"MO","Buchanan","29021",15594,18660,0.455246102644947,-3066
"MO","Butler","29023",4363,12248,0.2626572752995,-7885
"MO","Caldwell","29025",1313,2724,0.325241515977211,-1411
"MO","Callaway","29027",6070,11742,0.34078149562093,-5672
"MO","Camden","29029",6458,15089,0.299716897944029,-8631
"MO","Cape Girardeau","29031",9713,25343,0.277070972158832,-15630
"MO","Carroll","29033",1154,3072,0.273071462375769,-1918
"MO","Carter","29035",754,1978,0.275988286969253,-1224
"MO","Cass","29037",17044,30912,0.355409125031279,-13868
"MO","Cedar","29039",1536,4375,0.259854508543394,-2839
"MO","Chariton","29041",1339,2402,0.357925688318631,-1063
"MO","Christian","29043",9809,27465,0.263159306755379,-17656
"MO","Clark","29045",1398,1730,0.44693094629156,-332
"MO","Clay","29047",47250,56131,0.457047233050561,-8881
"MO","Clinton","29049",3685,5904,0.384294504119303,-2219
"MO","Cole","29051",12003,24488,0.328930421199748,-12485
"MO","Cooper","29053",2474,4887,0.336095639179459,-2413
"MO","Crawford","29055",2951,6434,0.314437932871604,-3483
"MO","Dade","29057",939,2895,0.24491392801252,-1956
"MO","Dallas","29059",2122,4992,0.298285071689626,-2870
"MO","Daviess","29061",1124,2282,0.330005871990605,-1158
"MO","DeKalb","29063",1194,3056,0.280941176470588,-1862
"MO","Dent","29065",1585,4883,0.245052566481138,-3298
"MO","Douglas","29067",1709,4649,0.268795218622208,-2940
"MO","Dunklin","29069",3635,6849,0.346718809614651,-3214
"MO","Franklin","29071",16294,29271,0.357599034346538,-12977
"MO","Gasconade","29073",2099,4895,0.300114383757506,-2796
"MO","Gentry","29075",937,1986,0.32056106739651,-1049
"MO","Greene","29077",46130,76786,0.375296950763123,-30656
"MO","Grundy","29079",1212,3030,0.285714285714286,-1818
"MO","Harrison","29081",984,2624,0.272727272727273,-1640
"MO","Henry","29083",3604,6229,0.366520899013526,-2625
"MO","Hickory","29085",1733,2835,0.379378283712785,-1102
"MO","Holt","29087",551,1725,0.242091388400703,-1174
"MO","Howard","29089",1722,3012,0.363751584283904,-1290
"MO","Howell","29091",4393,11541,0.275699761516255,-7148
"MO","Iron","29093",1669,2252,0.425656720224433,-583
"MO","Jackson","29095",180100,121891,0.596375388670523,58209
"MO","Jasper","29097",12808,31345,0.290082214119086,-18537
"MO","Jefferson","29099",41570,53973,0.435092052792983,-12403
"MO","Johnson","29101",7661,12750,0.375336828180883,-5089
"MO","Knox","29103",698,1205,0.366789280084078,-507
"MO","LaClede","29105",4093,10934,0.272376389166168,-6841
"MO","Lafayette","29107",5650,9800,0.365695792880259,-4150
"MO","Lawrence","29109",4014,11417,0.260125720951332,-7403
"MO","Lewis","29111",1507,2677,0.360181644359465,-1170
"MO","Lincoln","29113",7733,14330,0.350496306032724,-6597
"MO","Linn","29115",2031,3331,0.378776575904513,-1300
"MO","Livingston","29117",1906,4006,0.322395128552097,-2100
"MO","Macon","29121",2309,4700,0.329433585390213,-2391
"MO","Madison","29123",1588,3227,0.329802699896158,-1639
"MO","Maries","29125",1299,3165,0.290994623655914,-1866
"MO","Marion","29127",4034,7926,0.337290969899666,-3892
"MO","McDonald","29119",1920,5694,0.252167060677699,-3774
"MO","Mercer","29129",353,1255,0.21952736318408,-902
"MO","Miller","29131",2651,8099,0.246604651162791,-5448
"MO","Mississippi","29133",1857,2996,0.382649907273851,-1139
"MO","Moniteau","29135",1608,4703,0.254793218190461,-3095
"MO","Monroe","29137",1398,2564,0.352852094901565,-1166
"MO","Montgomery","29139",1734,3486,0.332183908045977,-1752
"MO","Morgan","29141",2773,5733,0.326005172819186,-2960
"MO","New Madrid","29143",2814,4284,0.396449704142012,-1470
"MO","Newton","29145",6425,18179,0.261136400585271,-11754
"MO","Nodaway","29147",3172,5593,0.361893896177981,-2421
"MO","Oregon","29149",1419,2886,0.329616724738676,-1467
"MO","Osage","29151",1472,5330,0.216406939135548,-3858
"MO","Ozark","29153",1261,3080,0.290486063119097,-1819
"MO","Pemiscot","29155",2671,3596,0.42620073400351,-925
"MO","Perry","29157",2184,5669,0.278110276327518,-3485
"MO","Pettis","29159",5902,10840,0.352526579859037,-4938
"MO","Phelps","29161",5798,11893,0.327737267537166,-6095
"MO","Pike","29163",2581,4576,0.360625960598016,-1995
"MO","Platte","29165",19171,25617,0.428038760382245,-6446
"MO","Polk","29167",3580,9252,0.278990024937656,-5672
"MO","Pulaski","29169",4199,9092,0.315928071627417,-4893
"MO","Putnam","29171",587,1673,0.259734513274336,-1086
"MO","Ralls","29173",1736,3231,0.349506744513791,-1495
"MO","Randolph","29175",3031,6667,0.31253866776655,-3636
"MO","Ray","29177",4264,5805,0.423478001787665,-1541
"MO","Reynolds","29179",1155,1927,0.374756651524984,-772
"MO","Ripley","29181",1396,3743,0.271648180579879,-2347
"MO","Saline","29195",3785,5096,0.426190744285553,-1311
"MO","Schuyler","29197",697,1174,0.372528059861037,-477
"MO","Scotland","29199",643,1246,0.340391741662255,-603
"MO","Scott","29201",5122,11623,0.305882352941176,-6501
"MO","Shannon","29203",1300,2260,0.365168539325843,-960
"MO","Shelby","29205",966,2188,0.306277742549144,-1222
"MO","St. Charles","29183",71798,110732,0.393349038514217,-38934
"MO","St. Clair","29185",1460,3019,0.325965617325296,-1559
"MO","St. Francois","29187",8837,13248,0.400135838804619,-4411
"MO","St. Louis City","29510",116654,22617,0.83760438282198,94037
"MO","St. Louis County","29189",294735,223102,0.569165586854551,71633
"MO","Ste. Genevieve","29186",3813,4055,0.484621250635486,-242
"MO","Stoddard","29207",3153,9496,0.249268716894616,-6343
"MO","Stone","29209",3920,11780,0.24968152866242,-7860
"MO","Sullivan","29211",908,1610,0.360603653693407,-702
"MO","Taney","29213",5462,15713,0.257945690672963,-10251
"MO","Texas","29215",2871,7618,0.27371532081228,-4747
"MO","Vernon","29217",2580,5756,0.309500959692898,-3176
"MO","Warren","29219",5219,9150,0.363212471292366,-3931
"MO","Washington","29221",3402,5008,0.404518430439952,-1606
"MO","Wayne","29223",1811,3790,0.323335118728798,-1979
"MO","Webster","29225",4407,10702,0.291680455357734,-6295
"MO","Worth","29227",341,664,0.339303482587065,-323
"MO","Wright","29229",1953,5831,0.25089928057554,-3878
"MS","Adams","28001",7999,5542,0.590724466435271,2457
"MS","Alcorn","28003",3449,11027,0.238256424426637,-7578
"MS","Amite","28005",3218,4393,0.422809092103534,-1175
"MS","Attala","28007",3368,4452,0.430690537084399,-1084
"MS","Benton","28009",2026,2030,0.499506903353057,-4
"MS","Bolivar","28011",9772,4346,0.692166029182604,5426
"MS","Calhoun","28013",2250,3961,0.362260505554661,-1711
"MS","Carroll","28015",1990,3953,0.334847720006731,-1963
"MS","Chickasaw","28017",3914,3601,0.5208250166334,313
"MS","Choctaw","28019",1283,2533,0.336215932914046,-1250
"MS","Claiborne","28021",4633,608,0.8839916046556,4025
"MS","Clarke","28023",2695,4415,0.379043600562588,-1720
"MS","Clay","28025",5860,3735,0.610734757686295,2125
"MS","Coahoma","28027",7164,2356,0.752521008403361,4808
"MS","Copiah","28029",7201,5714,0.557568718544328,1487
"MS","Covington","28031",3800,5282,0.418410041841004,-1482
"MS","DeSoto","28033",20979,42399,0.331013916500994,-21420
"MS","Forrest","28035",12079,15339,0.440550003647239,-3260
"MS","Franklin","28037",1706,2705,0.386760371797778,-999
"MS","George","28039",1352,8353,0.139309634209171,-7001
"MS","Greene","28041",1325,4528,0.226379634375534,-3203
"MS","Grenada","28043",5279,5980,0.468869348965272,-701
"MS","Hancock","28045",3879,12859,0.231748118054726,-8980
"MS","Harrison","28047",22242,38646,0.365293653921955,-16404
"MS","Hinds","28049",70512,26450,0.727212722509849,44062
"MS","Holmes","28051",6775,1264,0.842766513247916,5511
"MS","Humphreys","28053",3399,1069,0.760743061772605,2330
"MS","Issaquena","28055",479,302,0.613316261203585,177
"MS","Itawamba","28057",1599,6925,0.187587986860629,-5326
"MS","Jackson","28059",15452,33262,0.317198341339245,-17810
"MS","Jasper","28061",5097,4193,0.548654467168999,904
"MS","Jeff Davis","28065",4094,2439,0.626664625746212,1655
"MS","Jefferson","28063",3508,431,0.890581365828891,3077
"MS","Jones","28067",9146,20635,0.30710855914845,-11489
"MS","Kemper","28069",3239,1789,0.644192521877486,1450
"MS","Lafayette","28071",7098,9772,0.420746887966805,-2674
"MS","Lamar","28073",5037,17472,0.223777155804345,-12435
"MS","Lauderdale","28075",12642,17322,0.421906287545054,-4680
"MS","Lawrence","28077",2394,4153,0.365663662746296,-1759
"MS","Leake","28079",3599,4283,0.456609997462573,-684
"MS","Lee","28081",12043,22004,0.35371692072723,-9961
"MS","Leflore","28083",8423,3115,0.730022534234703,5308
"MS","Lincoln","28085",4879,9333,0.343301435406699,-4454
"MS","Lowndes","28087",12037,12399,0.492592895727615,-362
"MS","Madison","28089",20722,28507,0.420930752198907,-7785
"MS","Marion","28091",3833,7118,0.350013697379235,-3285
"MS","Marshall","28093",9581,6444,0.597878315132605,3137
"MS","Monroe","28095",6990,9661,0.419794606930515,-2671
"MS","Montgomery","28097",2245,2543,0.468880534670008,-298
"MS","Neshoba","28099",3030,7772,0.280503610442511,-4742
"MS","Newton","28101",3069,5909,0.341835598128759,-2840
"MS","Noxubee","28103",4920,1325,0.787830264211369,3595
"MS","Oktibbeha","28105",8030,7728,0.509582434319076,302
"MS","Panola","28107",9079,7629,0.543392386880536,1450
"MS","Pearl River","28109",3813,15836,0.194055677133696,-12023
"MS","Perry","28111",1519,4110,0.269852549298277,-2591
"MS","Pike","28113",9304,7986,0.538114517061886,1318
"MS","Pontotoc","28115",2785,9403,0.228503446012471,-6618
"MS","Prentiss","28117",2817,7075,0.284775576223211,-4258
"MS","Quitman","28119",2837,1116,0.717682772577789,1721
"MS","Rankin","28121",14425,46318,0.237475923151639,-31893
"MS","Scott","28123",4774,5728,0.454580079984765,-954
"MS","Sharkey","28125",1571,675,0.69946571682992,896
"MS","Simpson","28127",4723,7424,0.388820284843994,-2701
"MS","Smith","28129",1979,6049,0.246512207274539,-4070
"MS","Stone","28131",1794,4924,0.26704376302471,-3130
"MS","Sunflower","28133",7989,2907,0.733204845814978,5082
"MS","Tallahatchie","28135",3838,2480,0.60747071858183,1358
"MS","Tate","28137",4572,6666,0.406833956219968,-2094
"MS","Tippah","28139",2254,6625,0.253857416375718,-4371
"MS","Tishomingo","28141",1623,6070,0.210971012608865,-4447
"MS","Tunica","28143",3371,867,0.795422369042001,2504
"MS","Union","28145",2481,7759,0.24228515625,-5278
"MS","Walthall","28147",3386,4012,0.457691267910246,-626
"MS","Warren","28149",9899,9390,0.51319404842138,509
"MS","Washington","28151",12188,4870,0.714503458787666,7318
"MS","Wayne","28153",4116,6080,0.403687720674774,-1964
"MS","Webster","28155",1087,3684,0.227834835464263,-2597
"MS","Wilkinson","28157",2940,1275,0.697508896797153,1665
"MS","Winston","28159",4557,5147,0.469600164880462,-590
"MS","Yalobusha","28161",2984,3261,0.477822257806245,-277
"MS","Yazoo","28163",6220,4560,0.576994434137291,1660
"MT","Beaverhead","30001",1347,3251,0.292953458025228,-1904
"MT","Big Horn","30003",2830,1655,0.630992196209587,1175
"MT","Blaine","30005",1598,1169,0.57752078062884,429
"MT","Broadwater","30007",761,2150,0.261422191686706,-1389
"MT","Carbon","30009",2126,3513,0.377017201631495,-1387
"MT","Carter","30011",96,678,0.124031007751938,-582
"MT","Cascade","30013",14949,18039,0.453164787195344,-3090
"MT","Chouteau","30015",969,1751,0.35625,-782
"MT","Custer","30017",1824,3353,0.352327602858799,-1529
"MT","Daniels","30019",236,735,0.243048403707518,-499
"MT","Dawson","30021",1219,3024,0.287296724016026,-1805
"MT","Deer Lodge","30023",2829,1431,0.664084507042254,1398
"MT","Fallon","30025",236,1123,0.173657100809419,-887
"MT","Fergus","30027",1628,4243,0.277295179696815,-2615
"MT","Flathead","30029",13534,27694,0.328272048122635,-14160
"MT","Gallatin","30031",21534,24051,0.472392234287595,-2517
"MT","Garfield","30033",66,622,0.0959302325581395,-556
"MT","Glacier","30035",2784,1391,0.666826347305389,1393
"MT","Golden Valley","30037",110,351,0.238611713665944,-241
"MT","Granite","30039",533,1107,0.325,-574
"MT","Hill","30041",3372,3133,0.51837048424289,239
"MT","Jefferson","30043",2256,4042,0.358208955223881,-1786
"MT","Judith Basin","30045",336,852,0.282828282828283,-516
"MT","Lake","30047",5715,7084,0.446519259317134,-1369
"MT","Lewis and Clark","30049",15479,16673,0.481431948245832,-1194
"MT","Liberty","30051",257,698,0.269109947643979,-441
"MT","Lincoln","30053",2544,6045,0.296192804750262,-3501
"MT","Madison","30057",1285,3115,0.292045454545455,-1830
"MT","McCone","30055",221,742,0.229491173416407,-521
"MT","Meagher","30059",269,670,0.286474973375932,-401
"MT","Mineral","30061",698,1212,0.36544502617801,-514
"MT","Missoula","30063",34380,23285,0.596202202375791,11095
"MT","Musselshell","30065",482,1792,0.211961301671064,-1310
"MT","Park","30067",3728,4637,0.44566646742379,-909
"MT","Petroleum","30069",49,240,0.169550173010381,-191
"MT","Phillips","30071",471,1688,0.218156553960167,-1217
"MT","Pondera","30073",969,1666,0.367741935483871,-697
"MT","Powder River","30075",170,833,0.169491525423729,-663
"MT","Powell","30077",884,1798,0.329604772557793,-914
"MT","Prairie","30079",167,518,0.243795620437956,-351
"MT","Ravalli","30081",6466,12817,0.335321267437639,-6351
"MT","Richland","30083",992,3479,0.221874301051219,-2487
"MT","Roosevelt","30085",2044,1503,0.576261629546095,541
"MT","Rosebud","30087",1478,2035,0.420723028750356,-557
"MT","Sanders","30089",1716,3971,0.30174081237911,-2255
"MT","Sheridan","30091",661,1203,0.354613733905579,-542
"MT","Silver Bow","30093",10782,5374,0.667368160435751,5408
"MT","Stillwater","30095",1209,3237,0.271929824561404,-2028
"MT","Sweet Grass","30097",473,1584,0.229946524064171,-1111
"MT","Teton","30099",1073,2091,0.339127686472819,-1018
"MT","Toole","30101",582,1440,0.287833827893175,-858
"MT","Treasure","30103",114,317,0.264501160092807,-203
"MT","Valley","30105",1386,2337,0.372280419016922,-951
"MT","Wheatland","30107",272,690,0.282744282744283,-418
"MT","Wibaux","30109",25,421,0.0560538116591928,-396
"MT","Yellowstone","30111",26275,40421,0.393951661269042,-14146
"NC","Alamance","37001",28341,37712,0.429064539082252,-9371
"NC","Alexander","37003",4591,12207,0.273306345993571,-7616
"NC","Alleghany","37005",1574,3378,0.317851373182553,-1804
"NC","Anson","37007",6894,4125,0.625646610400218,2769
"NC","Ashe","37009",4100,8207,0.333143739335338,-4107
"NC","Avery","37011",1861,5708,0.245871317214956,-3847
"NC","Beaufort","37013",9399,13918,0.403096453231548,-4519
"NC","Bertie","37015",6537,3367,0.660036348949919,3170
"NC","Bladen","37017",8277,7947,0.510170118343195,330
"NC","Brunswick","37019",21932,34587,0.388046497637962,-12655
"NC","Buncombe","37021",70066,54429,0.562801718944536,15637
"NC","Burke","37023",13577,22109,0.380457322199182,-8532
"NC","Cabarrus","37025",32453,49125,0.397815587535855,-16672
"NC","Caldwell","37027",10795,23069,0.318775100401606,-12274
"NC","Camden","37029",1456,2995,0.327117501685015,-1539
"NC","Carteret","37031",10197,24598,0.293059347607415,-14401
"NC","Caswell","37033",5183,5471,0.486483949690257,-288
"NC","Catawba","37035",23954,44386,0.35051214515657,-20432
"NC","Chatham","37037",18252,16578,0.524031007751938,1674
"NC","Cherokee","37039",3339,9201,0.266267942583732,-5862
"NC","Chowan","37041",3507,3872,0.475267651443285,-365
"NC","Clay","37043",1573,3952,0.284705882352941,-2379
"NC","Cleveland","37045",16734,25440,0.396784748897425,-8706
"NC","Columbus","37047",10973,12863,0.460354086256083,-1890
"NC","Craven","37049",18556,26654,0.410440168104402,-8098
"NC","Cumberland","37051",74991,50191,0.599055774791903,24800
"NC","Currituck","37053",3521,7431,0.321493791088386,-3910
"NC","Dare","37055",7258,10102,0.418087557603687,-2844
"NC","Davidson","37057",20291,48935,0.293112414410771,-28644
"NC","Davie","37059",5652,14568,0.279525222551929,-8916
"NC","Duplin","37061",8923,11330,0.440576704685726,-2407
"NC","Durham","37063",109185,33326,0.766151384805383,75859
"NC","Edgecombe","37065",18249,8494,0.682384175298209,9755
"NC","Forsyth","37067",91606,79177,0.536388282206074,12429
"NC","Franklin","37069",13317,14480,0.479080476310393,-1163
"NC","Gaston","37071",32903,55817,0.370863390441839,-22914
"NC","Gates","37073",2745,2532,0.520181921546333,213
"NC","Graham","37075",1115,2743,0.289009849663038,-1628
"NC","Granville","37077",13529,12332,0.523142956575538,1197
"NC","Greene","37079",3761,4393,0.461246014226147,-632
"NC","Guilford","37081",145483,103964,0.583222087257013,41519
"NC","Halifax","37083",16931,8686,0.66092828980755,8245
"NC","Harnett","37085",16858,25070,0.402070215607708,-8212
"NC","Haywood","37087",11742,15553,0.430188679245283,-3811
"NC","Henderson","37089",18519,32860,0.360439089900543,-14341
"NC","Hertford","37091",7815,3001,0.722540680473373,4814
"NC","Hoke","37093",9915,6721,0.595996633806203,3194
"NC","Hyde","37095",1157,1183,0.494444444444444,-26
"NC","Iredell","37097",25952,49071,0.345920584354131,-23119
"NC","Jackson","37099",8052,8224,0.494716146473335,-172
"NC","Johnston","37101",27052,48206,0.359456801934678,-21154
"NC","Jones","37103",2335,2825,0.452519379844961,-490
"NC","Lee","37105",10577,13000,0.44861517580693,-2423
"NC","Lenoir","37107",13350,13763,0.492383727363257,-413
"NC","Lincoln","37109",10980,25184,0.303616856542418,-14204
"NC","Macon","37113",5692,10817,0.344781634260101,-5125
"NC","Madison","37115",4466,5379,0.453631284916201,-913
"NC","Martin","37117",6514,5963,0.522080628356175,551
"NC","McDowell","37111",6006,11732,0.338595106550908,-5726
"NC","Mecklenburg","37119",270705,170490,0.613572229966341,100215
"NC","Mitchell","37121",1810,5778,0.238534528202425,-3968
"NC","Montgomery","37123",4689,6389,0.423271348618884,-1700
"NC","Moore","37125",16371,29336,0.358172708775461,-12965
"NC","Nash","37127",24214,23769,0.504637058958381,445
"NC","New Hanover","37129",48038,52792,0.476425666964197,-4754
"NC","Northampton","37131",7210,3474,0.674840883564208,3736
"NC","Onslow","37133",18115,31695,0.363681991567958,-13580
"NC","Orange","37135",53404,21398,0.713938129996524,32006
"NC","Pamlico","37137",2632,4032,0.394957983193277,-1400
"NC","Pasquotank","37139",9970,7216,0.580123356220179,2754
"NC","Pender","37141",9455,14368,0.396885362884607,-4913
"NC","Perquimans","37143",2747,3814,0.418686175887822,-1067
"NC","Person","37145",8384,10467,0.44475094159461,-2083
"NC","Pitt","37147",40701,35534,0.533888633829606,5167
"NC","Polk","37149",4000,6219,0.391427732654859,-2219
"NC","Randolph","37151",14675,44913,0.246274417667987,-30238
"NC","Richmond","37153",9747,9236,0.513459411051994,511
"NC","Robeson","37155",23957,17093,0.583605359317905,6864
"NC","Rockingham","37157",16170,25037,0.392409056713665,-8867
"NC","Rowan","37159",22529,38622,0.368415888538209,-16093
"NC","Rutherford","37161",9277,18797,0.330448101446178,-9520
"NC","Sampson","37163",11496,14358,0.444650731028081,-2862
"NC","Scotland","37165",8131,5799,0.583704235463029,2332
"NC","Stanly","37167",8287,19698,0.296122922994461,-11411
"NC","Stokes","37169",5969,15142,0.282743593387334,-9173
"NC","Surry","37171",9005,19753,0.313130259406078,-10748
"NC","Swain","37173",2618,2976,0.468001430103683,-358
"NC","Transylvania","37175",6740,9522,0.41446316566228,-2782
"NC","Tyrrell","37177",835,929,0.473356009070295,-94
"NC","Union","37179",32032,60468,0.346291891891892,-28436
"NC","Vance","37181",13286,7406,0.642083897158322,5880
"NC","Wake","37183",286939,232933,0.551941631786286,54006
"NC","Warren","37185",6635,3111,0.680792119844039,3524
"NC","Washington","37187",3811,2615,0.593059446000622,1196
"NC","Watauga","37189",13371,14124,0.486306601200218,-753
"NC","Wayne","37191",23154,27536,0.456776484513711,-4382
"NC","Wilkes","37193",8089,20410,0.283834520509492,-12321
"NC","Wilson","37195",20745,17904,0.536753861678181,2841
"NC","Yadkin","37197",3928,12500,0.239103968833699,-8572
"NC","Yancey","37199",3954,5249,0.429642507877866,-1295
"ND","Adams","38001",328,916,0.263665594855305,-588
"ND","Barnes","38003",2389,2953,0.447210782478472,-564
"ND","Benson","38005",1232,867,0.5869461648404,365
"ND","Billings","38007",89,472,0.158645276292335,-383
"ND","Bottineau","38009",1163,2246,0.341155764153711,-1083
"ND","Bowman","38011",412,1277,0.243931320307874,-865
"ND","Burke","38013",230,766,0.230923694779116,-536
"ND","Burleigh","38015",14036,27811,0.335412335412335,-13775
"ND","Cass","38017",34632,36792,0.484879032258065,-2160
"ND","Cavalier","38019",818,1192,0.406965174129353,-374
"ND","Dickey","38021",849,1601,0.346530612244898,-752
"ND","Divide","38023",382,731,0.343216531895777,-349
"ND","Dunn","38025",493,1494,0.248112732762959,-1001
"ND","Eddy","38027",484,631,0.434080717488789,-147
"ND","Emmons","38029",383,1430,0.211252068394926,-1047
"ND","Foster","38031",604,1028,0.370098039215686,-424
"ND","Golden Valley","38033",161,740,0.178690344062153,-579
"ND","Grand Forks","38035",14008,15044,0.482169902244252,-1036
"ND","Grant","38037",331,1012,0.246463142218913,-681
"ND","Griggs","38039",535,770,0.409961685823755,-235
"ND","Hettinger","38041",313,998,0.238749046529367,-685
"ND","Kidder","38043",393,870,0.311163895486936,-477
"ND","LaMoure","38045",737,1374,0.349123638086215,-637
"ND","Logan","38047",221,799,0.216666666666667,-578
"ND","McHenry","38049",924,1651,0.358834951456311,-727
"ND","McIntosh","38051",456,1028,0.307277628032345,-572
"ND","McKenzie","38053",926,2450,0.274289099526066,-1524
"ND","McLean","38055",1660,3130,0.346555323590814,-1470
"ND","Mercer","38057",1161,3132,0.270440251572327,-1971
"ND","Morton","38059",4467,8669,0.340057856272838,-4202
"ND","Mountrail","38061",1401,1960,0.416840226123178,-559
"ND","Nelson","38063",766,862,0.47051597051597,-96
"ND","Oliver","38065",281,693,0.288501026694045,-412
"ND","Pembina","38067",1245,1893,0.396749521988528,-648
"ND","Pierce","38069",656,1462,0.309726156751652,-806
"ND","Ramsey","38071",2162,2659,0.448454677452811,-497
"ND","Ransom","38073",1341,1008,0.57088122605364,333
"ND","Renville","38075",398,850,0.318910256410256,-452
"ND","Richland","38077",3190,4213,0.430906389301634,-1023
"ND","Rolette","38079",3351,1090,0.75455978383247,2261
"ND","Sargent","38081",1073,876,0.550538737814264,197
"ND","Sheridan","38083",161,637,0.201754385964912,-476
"ND","Sioux","38085",900,223,0.801424755120214,677
"ND","Slope","38087",83,341,0.195754716981132,-258
"ND","Stark","38089",2805,8509,0.24792292734665,-5704
"ND","Steele","38091",515,495,0.50990099009901,20
"ND","Stutsman","38093",3561,5641,0.386981091067159,-2080
"ND","Towner","38095",511,619,0.452212389380531,-108
"ND","Traill","38097",1784,1963,0.476114224713104,-179
"ND","Walsh","38099",2118,2809,0.429876192409174,-691
"ND","Ward","38101",8412,16176,0.342118106393363,-7764
"ND","Wells","38103",671,1646,0.289598618903755,-975
"ND","Williams","38105",2288,7087,0.244053333333333,-4799
"NE","Adams","31001",3991,8235,0.326435465401603,-4244
"NE","Antelope","31003",571,2585,0.180925221799747,-2014
"NE","Arthur","31005",30,227,0.116731517509728,-197
"NE","Banner","31007",55,339,0.139593908629442,-284
"NE","Blaine","31009",29,268,0.0976430976430976,-239
"NE","Boone","31011",615,2136,0.223555070883315,-1521
"NE","Box Butte","31013",1634,2795,0.368932038834951,-1161
"NE","Boyd","31015",186,852,0.179190751445087,-666
"NE","Brown","31017",223,1298,0.146614069690993,-1075
"NE","Buffalo","31019",5266,13378,0.282450118000429,-8112
"NE","Burt","31021",1280,2016,0.388349514563107,-736
"NE","Butler","31023",1028,2729,0.273622571200426,-1701
"NE","Cass","31025",4298,7453,0.365756105863331,-3155
"NE","Cedar","31027",952,3231,0.227587855606024,-2279
"NE","Chase","31029",252,1573,0.138082191780822,-1321
"NE","Cherry","31031",436,2557,0.145673237554293,-2121
"NE","Cheyenne","31033",983,3134,0.238766091814428,-2151
"NE","Clay","31035",662,2213,0.230260869565217,-1551
"NE","Colfax","31037",959,2045,0.319241011984021,-1086
"NE","Cuming","31039",1015,2858,0.262070746191583,-1843
"NE","Custer","31041",1066,4251,0.200488997555012,-3185
"NE","Dakota","31043",2831,3048,0.481544480353802,-217
"NE","Dawes","31045",1102,2435,0.311563471868815,-1333
"NE","Dawson","31047",2157,5370,0.286568353925867,-3213
"NE","Deuel","31049",215,763,0.219836400817996,-548
"NE","Dixon","31051",870,1745,0.332695984703633,-875
"NE","Dodge","31053",5588,8937,0.384716006884682,-3349
"NE","Douglas","31055",99261,108319,0.478181905771269,-9058
"NE","Dundy","31057",176,791,0.18200620475698,-615
"NE","Fillmore","31059",794,1972,0.28705712219812,-1178
"NE","Franklin","31061",381,1110,0.255533199195171,-729
"NE","Frontier","31063",381,1005,0.274891774891775,-624
"NE","Furnas","31065",422,1767,0.19278209227958,-1345
"NE","Gage","31067",3870,5470,0.414346895074946,-1600
"NE","Garden","31069",242,829,0.225957049486461,-587
"NE","Garfield","31071",147,762,0.161716171617162,-615
"NE","Gosper","31073",230,732,0.239085239085239,-502
"NE","Grant","31075",30,322,0.0852272727272727,-292
"NE","Greeley","31077",340,820,0.293103448275862,-480
"NE","Hall","31079",6971,12412,0.359645049785895,-5441
"NE","Hamilton","31081",1136,3582,0.240779991521831,-2446
"NE","Harlan","31083",311,1248,0.199486850545221,-937
"NE","Hayes","31085",50,473,0.0956022944550669,-423
"NE","Hitchcock","31087",310,1386,0.182783018867925,-1076
"NE","Holt","31089",862,3789,0.185336486777037,-2927
"NE","Hooker","31091",59,330,0.151670951156812,-271
"NE","Howard","31093",914,1890,0.325962910128388,-976
"NE","Jefferson","31095",1185,2156,0.354684226279557,-971
"NE","Johnson","31097",790,1223,0.392449080973671,-433
"NE","Kearney","31099",761,2341,0.245325596389426,-1580
"NE","Keith","31101",920,3036,0.232558139534884,-2116
"NE","Keya Paha","31103",80,392,0.169491525423729,-312
"NE","Kimball","31105",391,1222,0.24240545567266,-831
"NE","Knox","31107",1055,2878,0.268243071446733,-1823
"NE","Lancaster","31109",59970,61177,0.495018448661543,-1207
"NE","Lincoln","31111",4350,10545,0.292044310171198,-6195
"NE","Logan","31113",68,356,0.160377358490566,-288
"NE","Loup","31115",62,290,0.176136363636364,-228
"NE","Madison","31119",3368,9874,0.254342244373962,-6506
"NE","McPherson","31117",41,237,0.147482014388489,-196
"NE","Merrick","31121",921,2477,0.271041789287816,-1556
"NE","Morrill","31123",450,1658,0.213472485768501,-1208
"NE","Nance","31125",477,1098,0.302857142857143,-621
"NE","Nemaha","31127",1089,1979,0.354954367666232,-890
"NE","Nuckolls","31129",567,1563,0.266197183098592,-996
"NE","Otoe","31131",2542,4226,0.375591016548463,-1684
"NE","Pawnee","31133",396,897,0.306264501160093,-501
"NE","Perkins","31135",237,1133,0.172992700729927,-896
"NE","Phelps","31137",875,3372,0.206027784318342,-2497
"NE","Pierce","31139",637,2707,0.19049043062201,-2070
"NE","Platte","31141",3095,9963,0.237019451677133,-6868
"NE","Polk","31143",527,1886,0.218400331537505,-1359
"NE","Red Willow","31145",940,3855,0.196037539103233,-2915
"NE","Richardson","31147",1180,2407,0.328965709506551,-1227
"NE","Rock","31149",103,669,0.133419689119171,-566
"NE","Saline","31151",2232,2518,0.469894736842105,-286
"NE","Sarpy","31153",24709,40318,0.379980623433343,-15609
"NE","Saunders","31155",3279,6725,0.327768892443023,-3446
"NE","Scotts Bluff","31157",4193,9427,0.307856093979442,-5234
"NE","Seward","31159",2362,4947,0.323163223423177,-2585
"NE","Sheridan","31161",389,2010,0.162150896206753,-1621
"NE","Sherman","31163",549,919,0.373978201634877,-370
"NE","Sioux","31165",101,623,0.139502762430939,-522
"NE","Stanton","31167",607,1945,0.237852664576803,-1338
"NE","Thayer","31169",724,1853,0.280946837407839,-1129
"NE","Thomas","31171",42,360,0.104477611940299,-318
"NE","Thurston","31173",1153,823,0.583502024291498,330
"NE","Valley","31175",494,1643,0.231165184838559,-1149
"NE","Washington","31177",3103,6857,0.311546184738956,-3754
"NE","Wayne","31179",1074,2493,0.301093355761144,-1419
"NE","Webster","31181",440,1255,0.259587020648968,-815
"NE","Wheeler","31183",93,345,0.212328767123288,-252
"NE","York","31185",1352,4814,0.219266947778138,-3462
"NH","Acworth","93300001",316,212,0.598484848484849,104
"NH","Albany","93300002",235,157,0.599489795918367,78
"NH","Alexandria","93300003",472,432,0.52212389380531,40
"NH","Allenstown","93300004",1149,981,0.53943661971831,168
"NH","Alstead","93300005",634,383,0.623402163225172,251
"NH","Alton","93300006",1207,2147,0.359868813357185,-940
"NH","Amherst","93300007",3501,3906,0.4726609963548,-405
"NH","Andover","93300008",777,571,0.576409495548961,206
"NH","Antrim","93300009",810,655,0.552901023890785,155
"NH","Ashland","93300010",587,522,0.529305680793508,65
"NH","Atkinson","93300011",1630,2691,0.377227493635732,-1061
"NH","Auburn","93300012",1219,1996,0.379160186625194,-777
"NH","Barnstead","93300013",1125,1254,0.472887767969735,-129
"NH","Barrington","93300014",2577,2271,0.531559405940594,306
"NH","Bartlett","93300015",1039,774,0.573083287369002,265
"NH","Bath","93300016",264,272,0.492537313432836,-8
"NH","Bedford","93300017",4713,7990,0.371014720932063,-3277
"NH","Belmont","93300018",1782,1816,0.495275152862702,-34
"NH","Bennington","93300019",395,363,0.521108179419525,32
"NH","Benton","93300020",79,96,0.451428571428571,-17
"NH","Berlin","93300021",2863,1248,0.696424227681829,1615
"NH","Bethlehem","93300022",862,534,0.617478510028653,328
"NH","Boscawen","93300023",1000,766,0.566251415628539,234
"NH","Bow","93300024",2509,2352,0.516148940547212,157
"NH","Bradford","93300025",503,456,0.524504692387904,47
"NH","Brentwood","93300026",1093,1301,0.45655806182122,-208
"NH","Bridgewater","93300027",343,352,0.493525179856115,-9
"NH","Bristol","93300028",779,821,0.486875,-42
"NH","Brookfield","93300029",171,251,0.40521327014218,-80
"NH","Brookline","93300030",1278,1623,0.440537745604964,-345
"NH","Campton","93300031",1050,765,0.578512396694215,285
"NH","Canaan","93300032",1089,709,0.60567296996663,380
"NH","Candia","93300033",937,1528,0.380121703853955,-591
"NH","Canterbury","93300034",905,629,0.589960886571056,276
"NH","Carroll","93300035",274,226,0.548,48
"NH","Center Harbor","93300036",308,406,0.431372549019608,-98
"NH","Charlestown","93300037",1365,856,0.614588023412877,509
"NH","Chatham","93300038",105,110,0.488372093023256,-5
"NH","Chester","93300039",1082,1622,0.400147928994083,-540
"NH","Chesterfield","93300040",1251,911,0.578630897317299,340
"NH","Chichester","93300041",731,784,0.482508250825083,-53
"NH","Claremont","93300042",3352,2147,0.609565375522822,1205
"NH","Clarksville","93300043",72,83,0.464516129032258,-11
"NH","Colebrook","93300044",472,506,0.482617586912065,-34
"NH","Columbia","93300045",155,183,0.458579881656805,-28
"NH","Concord","93300046",14097,7252,0.660311958405546,6845
"NH","Conway","93300047",2982,2144,0.581740148263753,838
"NH","Cornish","93300048",635,395,0.616504854368932,240
"NH","Croydon","93300049",196,233,0.456876456876457,-37
"NH","Dalton","93300050",241,240,0.501039501039501,1
"NH","Danbury","93300051",307,313,0.495161290322581,-6
"NH","Danville","93300052",983,1356,0.420265070542967,-373
"NH","Deerfield","93300053",1133,1485,0.432773109243697,-352
"NH","Deering","93300054",508,505,0.501480750246792,3
"NH","Derry","93300055",7573,8309,0.476829114721068,-736
"NH","Dixville","93300056",5,5,0.5,0
"NH","Dorchester","93300057",92,97,0.486772486772487,-5
"NH","Dover","93300058",9724,6162,0.612111292962357,3562
"NH","Dublin","93300059",671,375,0.641491395793499,296
"NH","Dummer","93300060",84,79,0.515337423312883,5
"NH","Dunbarton","93300061",794,958,0.453196347031963,-164
"NH","Durham","93300062",5074,2217,0.695926484707173,2857
"NH","East Kingston","93300063",592,916,0.392572944297082,-324
"NH","Easton","93300064",122,63,0.659459459459459,59
"NH","Eaton","93300065",163,119,0.578014184397163,44
"NH","Effingham","93300066",380,393,0.491591203104787,-13
"NH","Ellsworth","93300067",32,19,0.627450980392157,13
"NH","Enfield","93300068",1542,843,0.646540880503145,699
"NH","Epping","93300069",1793,1697,0.513753581661891,96
"NH","Epsom","93300070",1195,1333,0.472705696202532,-138
"NH","Errol","93300071",81,96,0.457627118644068,-15
"NH","Exeter","93300072",5194,3614,0.58969118982743,1580
"NH","Farmington","93300073",1545,1429,0.519502353732347,116
"NH","Fitzwilliam","93300074",753,550,0.577897160399079,203
"NH","Francestown","93300075",538,449,0.545086119554205,89
"NH","Franconia","93300076",479,276,0.634437086092715,203
"NH","Franklin","93300077",2059,1570,0.567373932212731,489
"NH","Freedom","93300078",438,478,0.478165938864629,-40
"NH","Fremont","93300079",1039,1380,0.429516329061596,-341
"NH","Gilford","93300080",2133,2448,0.465618860510805,-315
"NH","Gilmanton","93300081",1013,1151,0.4681146025878,-138
"NH","Gilsum","93300082",231,192,0.546099290780142,39
"NH","Goffstown","93300083",4231,4856,0.465610212391328,-625
"NH","Gorham","93300084",1020,524,0.660621761658031,496
"NH","Goshen","93300085",227,202,0.529137529137529,25
"NH","Grafton","93300086",339,315,0.518348623853211,24
"NH","Grantham","93300087",1144,831,0.579240506329114,313
"NH","Greenfield","93300088",461,394,0.539181286549708,67
"NH","Greenland","93300089",1355,1159,0.538981702466189,196
"NH","Greenville","93300090",509,424,0.545551982851018,85
"NH","Groton","93300091",139,155,0.472789115646259,-16
"NH","Hampstead","93300092",2012,3217,0.384777204054312,-1205
"NH","Hampton","93300093",4843,4742,0.505268648930621,101
"NH","Hampton Falls","93300094",548,917,0.374061433447099,-369
"NH","Hancock","93300095",738,465,0.613466334164589,273
"NH","Hanover","93300096",5469,1727,0.760005558643691,3742
"NH","Harrisville","93300097",478,208,0.696793002915452,270
"NH","Harts Location","93300098",23,9,0.71875,14
"NH","Haverhill","93300099",974,975,0.499743458183684,-1
"NH","Hebron","93300100",171,222,0.435114503816794,-51
"NH","Henniker","93300101",1515,1009,0.600237717908082,506
"NH","Hill","93300102",286,267,0.517179023508137,19
"NH","Hillsborough","93300103",1490,1213,0.551239363669996,277
"NH","Hinsdale","93300104",1227,504,0.708838821490468,723
"NH","Holderness","93300105",755,547,0.579877112135177,208
"NH","Hollis","93300106",2289,2785,0.451123374063855,-496
"NH","Hooksett","93300107",3319,3968,0.455468642788528,-649
"NH","Hopkinton","93300108",2264,1471,0.60615796519411,793
"NH","Hudson","93300109",5451,5174,0.513035294117647,277
"NH","Jackson","93300110",423,259,0.620234604105572,164
"NH","Jaffrey","93300111",1538,1235,0.554633970429138,303
"NH","Jefferson","93300112",274,311,0.468376068376068,-37
"NH","Keene","93300113",8667,3592,0.706990782282405,5075
"NH","Kensington","93300114",587,739,0.442684766214178,-152
"NH","Kingston","93300115",1518,1854,0.45017793594306,-336
"NH","Laconia","93300116",3932,3856,0.504879301489471,76
"NH","Lancaster","93300117",864,742,0.537982565379826,122
"NH","Landaff","93300118",133,109,0.549586776859504,24
"NH","Langdon","93300119",223,164,0.576227390180879,59
"NH","Lebanon","93300120",4772,2060,0.69847775175644,2712
"NH","Lee","93300121",1621,921,0.637686860739575,700
"NH","Lempster","93300122",294,316,0.481967213114754,-22
"NH","Lincoln","93300123",446,337,0.569604086845466,109
"NH","Lisbon","93300124",386,322,0.545197740112994,64
"NH","Litchfield","93300125",1956,2703,0.419832582099163,-747
"NH","Littleton","93300126",1566,1293,0.547743966421826,273
"NH","Londonderry","93300127",5660,7295,0.436896950984176,-1635
"NH","Loudon","93300128",1414,1546,0.477702702702703,-132
"NH","Lyman","93300129",161,140,0.534883720930233,21
"NH","Lyme","93300130",932,274,0.772802653399668,658
"NH","Lyndeborough","93300131",535,480,0.527093596059113,55
"NH","Madbury","93300132",673,466,0.590869183494293,207
"NH","Madison","93300133",793,596,0.570914326853852,197
"NH","Manchester","93300134",25676,20809,0.552350220501237,4867
"NH","Marlborough","93300135",801,348,0.697127937336815,453
"NH","Marlow","93300136",262,154,0.629807692307692,108
"NH","Mason","93300137",331,476,0.410161090458488,-145
"NH","Meredith","93300138",1853,2088,0.470185232174575,-235
"NH","Merrimack","93300139",6797,7678,0.469568221070812,-881
"NH","Middleton","93300140",416,439,0.486549707602339,-23
"NH","Milan","93300141",435,283,0.605849582172702,152
"NH","Milford","93300142",3940,3773,0.510825878387139,167
"NH","Millsfield","93300143",5,16,0.238095238095238,-11
"NH","Milton","93300144",1104,1124,0.495511669658887,-20
"NH","Monroe","93300145",216,267,0.447204968944099,-51
"NH","Mont Vernon","93300146",691,775,0.471350613915416,-84
"NH","Moultonborough","93300147",1204,1822,0.397884996695307,-618
"NH","Nashua","93300148",23213,17506,0.570077850634839,5707
"NH","Nelson","93300149",295,150,0.662921348314607,145
"NH","New Boston","93300150",1399,1736,0.446251993620415,-337
"NH","New Castle","93300152",396,419,0.485889570552147,-23
"NH","New Durham","93300153",699,889,0.440176322418136,-190
"NH","New Hampton","93300155",646,636,0.50390015600624,10
"NH","New Ipswich","93300157",819,1688,0.326685281212605,-869
"NH","New London","93300158",1737,1384,0.556552387055431,353
"NH","Newbury","93300151",664,680,0.494047619047619,-16
"NH","Newfields","93300154",564,521,0.519815668202765,43
"NH","Newington","93300156",262,298,0.467857142857143,-36
"NH","Newmarket","93300159",3230,1893,0.630489947296506,1337
"NH","Newport","93300160",1448,1310,0.525018129079043,138
"NH","Newton","93300161",1104,1395,0.441776710684274,-291
"NH","North Hampton","93300163",1462,1558,0.484105960264901,-96
"NH","Northfield","93300162",1242,1013,0.550776053215078,229
"NH","Northumberland","93300164",621,366,0.629179331306991,255
"NH","Northwood","93300165",1198,1189,0.501885211562631,9
"NH","Nottingham","93300166",1364,1379,0.497265767407947,-15
"NH","Orange","93300167",107,72,0.597765363128492,35
"NH","Orford","93300168",455,239,0.655619596541787,216
"NH","Ossipee","93300169",961,1142,0.45696623870661,-181
"NH","Pelham","93300170",2870,4184,0.406861355259427,-1314
"NH","Pembroke","93300171",2102,1729,0.548681806316889,373
"NH","Peterborough","93300172",2479,1309,0.654435058078142,1170
"NH","Piermont","93300173",255,161,0.612980769230769,94
"NH","Pittsburg","93300174",180,317,0.362173038229376,-137
"NH","Pittsfield","93300175",959,936,0.506068601583114,23
"NH","Plainfield","93300176",976,457,0.681088625261689,519
"NH","Plaistow","93300177",1709,2387,0.417236328125,-678
"NH","Plymouth","93300178",2313,1111,0.675525700934579,1202
"NH","Portsmouth","93300179",8828,4088,0.683493341591824,4740
"NH","Randolph","93300180",172,77,0.690763052208835,95
"NH","Raymond","93300181",2289,2632,0.465149359886202,-343
"NH","Richmond","93300182",330,325,0.50381679389313,5
"NH","Rindge","93300183",1410,1716,0.4510556621881,-306
"NH","Rochester","93300184",7493,6816,0.523656440002795,677
"NH","Rollinsford","93300185",837,680,0.55174686882004,157
"NH","Roxbury","93300186",110,41,0.728476821192053,69
"NH","Rumney","93300187",411,438,0.484098939929329,-27
"NH","Rye","93300188",1930,1873,0.507494083618196,57
"NH","Salem","93300189",6026,8285,0.421074697784921,-2259
"NH","Salisbury","93300190",400,387,0.508259212198221,13
"NH","Sanbornton","93300191",888,913,0.49305941143809,-25
"NH","Sandown","93300192",1298,1922,0.403105590062112,-624
"NH","Sandwich","93300193",609,403,0.601778656126482,206
"NH","Seabrook","93300194",2030,2211,0.478660693232728,-181
"NH","Sharon","93300195",162,91,0.640316205533597,71
"NH","Shelburne","93300196",139,118,0.540856031128405,21
"NH","Somersworth","93300197",3028,2151,0.584668854991311,877
"NH","South Hampton","93300198",240,322,0.427046263345196,-82
"NH","Springfield","93300199",365,398,0.478374836173001,-33
"NH","Stark","93300200",164,133,0.552188552188552,31
"NH","Stewartstown","93300201",161,193,0.454802259887006,-32
"NH","Stoddard","93300202",403,337,0.544594594594595,66
"NH","Strafford","93300203",1235,1214,0.504287464271131,21
"NH","Stratford","93300204",167,105,0.613970588235294,62
"NH","Stratham","93300205",2411,2395,0.501664585934249,16
"NH","Sugar Hill","93300206",248,153,0.618453865336658,95
"NH","Sullivan","93300207",221,148,0.598915989159892,73
"NH","Sunapee","93300208",916,1075,0.460070316423908,-159
"NH","Surry","93300209",270,219,0.552147239263804,51
"NH","Sutton","93300210",654,545,0.545454545454545,109
"NH","Swanzey","93300211",2133,1497,0.587603305785124,636
"NH","Tamworth","93300212",843,718,0.540038436899423,125
"NH","Temple","93300213",435,413,0.512971698113208,22
"NH","Thornton","93300214",743,611,0.548744460856721,132
"NH","Tilton","93300215",997,853,0.538918918918919,144
"NH","Troy","93300216",553,413,0.572463768115942,140
"NH","Tuftonboro","93300217",671,984,0.405438066465257,-313
"NH","Unity","93300218",424,359,0.541507024265645,65
"NH","Wakefield","93300219",1083,1448,0.427894112998815,-365
"NH","Walpole","93300220",1284,793,0.618199325950891,491
"NH","Warner","93300221",938,694,0.574754901960784,244
"NH","Warren","93300222",233,206,0.530751708428246,27
"NH","Washington","93300223",285,314,0.475792988313856,-29
"NH","Waterville","93300224",136,105,0.564315352697095,31
"NH","Weare","93300225",2105,2592,0.448158398978071,-487
"NH","Webster","93300226",623,496,0.55674709562109,127
"NH","Wentworth","93300227",218,260,0.456066945606695,-42
"NH","Wentworth's Location","93300228",9,13,0.409090909090909,-4
"NH","Westmoreland","93300229",676,411,0.621895124195032,265
"NH","Whitefield","93300230",633,478,0.56975697569757,155
"NH","Wilmot","93300231",492,361,0.576787807737397,131
"NH","Wilton","93300232",1137,1022,0.526632700324224,115
"NH","Winchester","93300233",1131,633,0.641156462585034,498
"NH","Windham","93300234",2964,5224,0.361993160723009,-2260
"NH","Windsor","93300235",42,66,0.388888888888889,-24
"NH","Wolfeboro","93300236",1854,2400,0.435825105782793,-546
"NH","Woodstock","93300237",456,307,0.597640891218873,149
"NJ","Atlantic","34001",59509,41918,0.586717540694292,17591
"NJ","Bergen","34003",193470,155267,0.554773367896151,38203
"NJ","Burlington","34005",115951,79110,0.594434561496147,36841
"NJ","Camden","34007",137795,63329,0.685124599749408,74466
"NJ","Cape May","34009",21275,25488,0.454953702713684,-4213
"NJ","Cumberland","34011",30172,18767,0.616522609779521,11405
"NJ","Essex","34013",217950,61595,0.779659804324885,156355
"NJ","Gloucester","34015",72960,58915,0.553251184834123,14045
"NJ","Hudson","34017",136239,38082,0.781540950315797,98157
"NJ","Hunterdon","34019",25148,36979,0.404783749416518,-11831
"NJ","Mercer","34021",94300,43155,0.686042704885235,51145
"NJ","Middlesex","34023",179515,102472,0.63660736133226,77043
"NJ","Monmouth","34025",125471,140376,0.4719669584385,-14905
"NJ","Morris","34027",90313,114265,0.441459981034129,-23952
"NJ","Ocean","34029",96500,138594,0.410474108229049,-42094
"NJ","Passaic","34031",104057,59181,0.637455739472427,44876
"NJ","Salem","34033",14456,14214,0.504220439483781,242
"NJ","Somerset","34035",70168,63159,0.52628499853743,7009
"NJ","Sussex","34037",23406,37215,0.386103825407037,-13809
"NJ","Union","34039",134220,66457,0.668835990173263,67763
"NJ","Warren","34041",17869,24695,0.419814867023776,-6826
"NM","Bernalillo","35001",147183,104242,0.585395247091578,42941
"NM","Catron","35003",557,1474,0.27424913835549,-917
"NM","Chaves","35005",6621,13271,0.332847375829479,-6650
"NM","Cibola","35006",4907,2966,0.623269401752826,1941
"NM","Colfax","35007",2879,2763,0.510280042538107,116
"NM","Curry","35009",3956,9150,0.301846482527087,-5194
"NM","DeBaca","35011",287,586,0.328751431844215,-299
"NM","Dona Ana","35013",36778,26988,0.576765047203839,9790
"NM","Eddy","35015",6110,12546,0.327508576329331,-6436
"NM","Grant","35017",7009,5286,0.570069133794225,1723
"NM","Guadalupe","35019",1388,518,0.728226652675761,870
"NM","Harding","35021",260,326,0.443686006825939,-66
"NM","Hidalgo","35023",994,895,0.526204340921122,99
"NM","Lea","35025",4068,12480,0.24583031182016,-8412
"NM","Lincoln","35027",2931,5940,0.330402434900237,-3009
"NM","Los Alamos","35028",5191,4796,0.519775708420947,395
"NM","Luna","35029",3573,3654,0.49439601494396,-81
"NM","McKinley","35031",15363,5420,0.739209931193764,9943
"NM","Mora","35033",1952,591,0.767597325992922,1361
"NM","Otero","35035",6715,12219,0.354653005175874,-5504
"NM","Quay","35037",1382,2194,0.386465324384787,-812
"NM","Rio Arriba","35039",11389,3373,0.771507925755318,8016
"NM","Roosevelt","35041",1719,4032,0.298904538341158,-2313
"NM","San Juan","35045",15688,28779,0.352800953516091,-13091
"NM","San Miguel","35047",8754,2281,0.793294064340734,6473
"NM","Sandoval","35043",26831,24124,0.526562653321558,2707
"NM","Santa Fe","35049",49668,15145,0.766327742891087,34523
"NM","Sierra","35051",1963,2928,0.401349417297076,-965
"NM","Socorro","35053",3983,2698,0.596168238287682,1285
"NM","Taos","35055",11855,2710,0.813937521455544,9145
"NM","Torrance","35057",2414,3521,0.406739679865206,-1107
"NM","Union","35059",471,1231,0.276733254994125,-760
"NM","Valencia","35061",13473,12788,0.513042153764137,685
"NV","Carson City","32510",10290,12394,0.453623699523893,-2104
"NV","Churchill","32001",2961,7061,0.295450009978048,-4100
"NV","Clark","32003",387978,288223,0.573761352024028,99755
"NV","Douglas","32005",9288,16264,0.363494051346274,-6976
"NV","Elko","32007",3510,12013,0.226116085808156,-8503
"NV","Esmeralda","32009",92,317,0.224938875305623,-225
"NV","Eureka","32011",107,663,0.138961038961039,-556
"NV","Humboldt","32013",1737,3810,0.313142239048134,-2073
"NV","Lander","32015",534,1580,0.252601702932829,-1046
"NV","Lincoln","32017",400,1691,0.191296030607365,-1291
"NV","Lyon","32019",7380,13520,0.35311004784689,-6140
"NV","Mineral","32021",863,1080,0.444158517756047,-217
"NV","Nye","32023",6320,10566,0.37427454696198,-4246
"NV","Pershing","32027",632,1167,0.351306281267371,-535
"NV","Storey","32029",920,1321,0.410531012940651,-401
"NV","Washoe","32031",94806,88151,0.518187333635772,6655
"NV","White Pine","32033",983,2601,0.274274553571429,-1618
"NY","Albany","36001",80891,42029,0.658078424991865,38862
"NY","Allegany","36003",5658,9609,0.370603261937512,-3951
"NY","Bronx","36005",288378,26304,0.916410852860983,262074
"NY","Brooklyn","36047",503291,108630,0.822477084460249,394661
"NY","Broome","36007",38315,34878,0.523479021217876,3437
"NY","Cattaraugus","36009",11695,15406,0.431533891738312,-3711
"NY","Cayuga","36011",14162,11355,0.555002547321394,2807
"NY","Chautauqua","36013",21815,25795,0.458202058391094,-3980
"NY","Chemung","36015",15285,16207,0.485361361615648,-922
"NY","Chenango","36017",8340,8933,0.482834481560817,-593
"NY","Clinton","36019",17123,10054,0.630054825771792,7069
"NY","Columbia","36021",14244,11194,0.55994968157874,3050
"NY","Cortland","36023",9445,7886,0.544977208470371,1559
"NY","Delaware","36025",7469,9085,0.451190044702187,-1616
"NY","Dutchess","36027",59885,52320,0.533710618956375,7565
"NY","Erie","36029",220184,159678,0.57964208054504,60506
"NY","Essex","36031",8835,6495,0.576320939334638,2340
"NY","Franklin","36033",9065,5248,0.633340319988821,3817
"NY","Fulton","36035",7916,9811,0.446550459750663,-1895
"NY","Genesee","36037",8886,13701,0.393412139726391,-4815
"NY","Greene","36039",7911,9935,0.443292614591505,-2024
"NY","Hamilton","36041",955,1652,0.366321442270809,-697
"NY","Herkimer","36043",10433,12389,0.45714661291736,-1956
"NY","Jefferson","36045",15345,16279,0.485232734631925,-934
"NY","Lewis","36049",4263,5083,0.456130965118767,-820
"NY","Livingston","36051",10889,13210,0.451844474874476,-2321
"NY","Madison","36053",12698,12611,0.501718756173693,87
"NY","Manhattan","36061",417861,72300,0.852497444717144,345561
"NY","Monroe","36055",178491,124769,0.588574160786124,53722
"NY","Montgomery","36057",7881,8622,0.477549536447919,-741
"NY","Nassau","36059",243649,212882,0.533696506918479,30767
"NY","Niagara","36063",40862,40397,0.502861221526231,465
"NY","Oneida","36065",37388,41639,0.47310412896858,-4251
"NY","Onondaga","36067",112664,72807,0.607448064657008,39857
"NY","Ontario","36069",21285,21998,0.491763509923065,-713
"NY","Orange","36071",67709,60984,0.526128072233921,6725
"NY","Orleans","36073",5411,8076,0.401201156669385,-2665
"NY","Oswego","36075",21733,18503,0.54013818471021,3230
"NY","Otsego","36077",10975,10527,0.510417635568784,448
"NY","Putnam","36079",17851,22436,0.443095787723087,-4585
"NY","Queens","36081",399970,103193,0.794911390543422,296777
"NY","Rensselaer","36083",34713,27240,0.560311849305118,7473
"NY","Rockland","36087",60446,52936,0.533118131625831,7510
"NY","Saint Lawrence","36089",19574,13914,0.584507883420927,5660
"NY","Saratoga","36091",48876,46829,0.510694321090852,2047
"NY","Schenectady","36093",33777,24608,0.578521880620022,9169
"NY","Schoharie","36095",4862,6849,0.415165229271625,-1987
"NY","Schuyler","36097",3354,3942,0.459703947368421,-588
"NY","Seneca","36099",6526,5405,0.546978459475316,1121
"NY","Staten Island","36085",67524,66420,0.504121125246372,1104
"NY","Steuben","36101",14586,20425,0.416611921967382,-5839
"NY","Suffolk","36103",274830,259348,0.514491424206912,15482
"NY","Sullivan","36105",13781,11148,0.552809980344177,2633
"NY","Tioga","36107",8263,11278,0.422854511028095,-3015
"NY","Tompkins","36109",24447,10202,0.705561488066034,14245
"NY","Ulster","36111",43164,27340,0.61222058322932,15824
"NY","Warren","36113",13112,12571,0.51053225869252,541
"NY","Washington","36115",10596,10254,0.508201438848921,342
"NY","Wayne","36117",15136,18315,0.452482735942124,-3179
"NY","Westchester","36119",171908,108707,0.612611585268072,63201
"NY","Wyoming","36121",5224,9726,0.34943143812709,-4502
"NY","Yates","36123",4021,4270,0.484983717283802,-249
"OH","Adams","39001",3857,6691,0.365661736822146,-2834
"OH","Allen","39003",16869,28802,0.369359111909089,-11933
"OH","Ashland","39005",8083,15225,0.346790801441565,-7142
"OH","Ashtabula","39007",22964,17890,0.562099182454594,5074
"OH","Athens","39009",17268,8118,0.680217442684944,9150
"OH","Auglaize","39011",5643,16802,0.251414568946313,-11159
"OH","Belmont","39013",13826,16418,0.457148525327338,-2592
"OH","Brown","39015",6923,11671,0.372324405722276,-4748
"OH","Butler","39017",59282,102226,0.36705302523714,-42944
"OH","Carroll","39019",5396,7177,0.42917362602402,-1781
"OH","Champaign","39021",7826,11852,0.397703018599451,-4026
"OH","Clark","39023",30022,31116,0.491053027576957,-1094
"OH","Clermont","39025",29334,62527,0.319330292507158,-33193
"OH","Clinton","39027",5534,11740,0.320365867778164,-6206
"OH","Columbiana","39029",19351,24778,0.438509823472093,-5427
"OH","Coshocton","39031",6841,8312,0.451461756747839,-1471
"OH","Crawford","39033",7207,11561,0.384004688832055,-4354
"OH","Cuyahoga","39035",420953,184475,0.695298202263523,236478
"OH","Darke","39037",6610,17745,0.271402176144529,-11135
"OH","Defiance","39039",7438,9935,0.428135612732401,-2497
"OH","Delaware","39041",36131,58980,0.379882453133707,-22849
"OH","Erie","39043",20969,16655,0.557330427386774,4314
"OH","Fairfield","39045",28831,40134,0.418052635394765,-11303
"OH","Fayette","39047",4075,6456,0.386952806001329,-2381
"OH","Franklin","39049",325654,207941,0.610301820669234,117713
"OH","Fulton","39051",8790,11521,0.432770419969475,-2731
"OH","Gallia","39053",3418,5912,0.366345123258307,-2494
"OH","Geauga","39055",19295,30104,0.390594951314804,-10809
"OH","Greene","39057",31028,48683,0.389256187979074,-17655
"OH","Guernsey","39059",7226,8811,0.450583026750639,-1585
"OH","Hamilton","39061",208508,188653,0.524996160247356,19855
"OH","Hancock","39063",12192,22077,0.355773439551781,-9885
"OH","Hardin","39065",4487,7337,0.379482408660352,-2850
"OH","Harrison","39067",2895,3936,0.423803249890206,-1041
"OH","Henry","39069",5513,8111,0.404653552554316,-2598
"OH","Highland","39071",5772,11032,0.343489645322542,-5260
"OH","Hocking","39073",6010,6150,0.494243421052632,-140
"OH","Holmes","39075",2568,8563,0.230707034408409,-5995
"OH","Huron","39077",10673,12821,0.454286200732102,-2148
"OH","Jackson","39079",4965,7651,0.39354787571338,-2686
"OH","Jefferson","39081",14960,16729,0.472088106282937,-1769
"OH","Knox","39083",10154,16873,0.375698375698376,-6719
"OH","Lake","39085",55219,57150,0.491407772606324,-1931
"OH","Lawrence","39087",10454,14371,0.42110775427996,-3917
"OH","Licking","39089",32264,43604,0.425264933832446,-11340
"OH","Logan","39091",6789,13323,0.337559665871122,-6534
"OH","Lorain","39093",78112,58095,0.57348007077463,20017
"OH","Lucas","39095",129229,68100,0.654891070243097,61129
"OH","Madison","39097",6700,10215,0.396098137747561,-3515
"OH","Mahoning","39099",74298,41702,0.6405,32596
"OH","Marion","39101",11933,13938,0.461250048316648,-2005
"OH","Medina","39103",37841,49464,0.43343451119638,-11623
"OH","Meigs","39105",3911,5782,0.403487052512122,-1871
"OH","Mercer","39107",4609,16207,0.22141621829362,-11598
"OH","Miami","39109",15731,33650,0.318563820092748,-17919
"OH","Monroe","39111",3007,3540,0.459294333282419,-533
"OH","Montgomery","39113",128983,121188,0.515579343728889,7795
"OH","Morgan","39115",2772,3136,0.469194312796209,-364
"OH","Morrow","39117",5780,9662,0.374303846651988,-3882
"OH","Muskingum","39119",16327,18826,0.464455380764088,-2499
"OH","Noble","39121",2082,3498,0.373118279569892,-1416
"OH","Ottawa","39123",11214,10323,0.520685332218972,891
"OH","Paulding","39125",3435,5248,0.395600598871358,-1813
"OH","Perry","39127",6857,7498,0.477673284569836,-641
"OH","Pickaway","39129",9335,13713,0.405024297119056,-4378
"OH","Pike","39131",5490,5535,0.497959183673469,-45
"OH","Portage","39133",38082,34465,0.524928666933161,3617
"OH","Preble","39135",6005,13202,0.312646430988702,-7197
"OH","Putnam","39137",4238,13563,0.238076512555474,-9325
"OH","Richland","39139",21785,33057,0.397232048430035,-11272
"OH","Ross","39141",13895,14582,0.487937633879973,-687
"OH","Sandusky","39143",14035,13491,0.509881566518928,544
"OH","Scioto","39145",14432,15023,0.489967747411305,-591
"OH","Seneca","39147",10962,13025,0.456997540334348,-2063
"OH","Shelby","39149",6065,16700,0.266417746540742,-10635
"OH","Stark","39151",86314,86958,0.498141650122351,-644
"OH","Summit","39153",147146,108700,0.575135042173808,38446
"OH","Trumbull","39155",59446,37545,0.612902228041777,21901
"OH","Tuscarawas","39157",17516,21420,0.449866447503596,-3904
"OH","Union","39159",8546,15947,0.348916016821133,-7401
"OH","Van Wert","39161",3923,9433,0.293725666367176,-5510
"OH","Vinton","39163",2382,2798,0.45984555984556,-416
"OH","Warren","39165",31907,74626,0.299503440248561,-42719
"OH","Washington","39167",11333,16921,0.401111347065902,-5588
"OH","Wayne","39169",18932,29450,0.391302550535323,-10518
"OH","Williams","39171",7045,9863,0.416666666666667,-2818
"OH","Wood","39173",31596,28997,0.5214463716931,2599
"OH","Wyandot","39175",3962,6054,0.395567092651757,-2092
"OK","Adair","40001",2110,4362,0.32601977750309,-2252
"OK","Alfalfa","40003",278,1539,0.152999449642267,-1261
"OK","Atoka","40005",1241,3534,0.259895287958115,-2293
"OK","Beaver","40007",243,2057,0.105652173913043,-1814
"OK","Beckham","40009",1413,5496,0.204515848892749,-4083
"OK","Blaine","40011",991,2824,0.259764089121887,-1833
"OK","Bryan","40013",3533,9188,0.277729738228127,-5655
"OK","Caddo","40015",3151,5660,0.357621155373964,-2509
"OK","Canadian","40017",10533,35615,0.22824391089538,-25082
"OK","Carter","40019",4907,12213,0.286623831775701,-7306
"OK","Cherokee","40021",6137,8151,0.429521276595745,-2014
"OK","Choctaw","40023",1494,3572,0.29490722463482,-2078
"OK","Cimarron","40025",115,1082,0.0960735171261487,-967
"OK","Cleveland","40027",34701,59019,0.370262483994878,-24318
"OK","Coal","40029",648,1709,0.274925753075944,-1061
"OK","Comanche","40031",12517,17657,0.414827334791542,-5140
"OK","Cotton","40033",657,1796,0.267835303709743,-1139
"OK","Craig","40035",1746,3552,0.32955832389581,-1806
"OK","Creek","40037",7114,18964,0.272796993634481,-11850
"OK","Custer","40039",2358,7442,0.240612244897959,-5084
"OK","Delaware","40041",4176,10056,0.293423271500843,-5880
"OK","Dewey","40043",301,1769,0.145410628019324,-1468
"OK","Ellis","40045",226,1575,0.125485841199334,-1349
"OK","Garfield","40047",4732,15176,0.237693389592124,-10444
"OK","Garvin","40049",2556,6922,0.269677147077443,-4366
"OK","Grady","40051",4780,14818,0.24390243902439,-10038
"OK","Grant","40053",393,1674,0.190130624092888,-1281
"OK","Greer","40055",488,1344,0.266375545851528,-856
"OK","Harmon","40057",264,659,0.28602383531961,-395
"OK","Harper","40059",173,1261,0.120641562064156,-1088
"OK","Haskell","40061",1175,3069,0.276861451460886,-1894
"OK","Hughes","40063",1370,2836,0.325725154541132,-1466
"OK","Jackson","40065",1953,5962,0.246746683512318,-4009
"OK","Jefferson","40067",602,1632,0.269471799462847,-1030
"OK","Johnston","40069",1134,2644,0.300158814187401,-1510
"OK","Kay","40071",4624,11498,0.286813050490014,-6874
"OK","Kingfisher","40073",844,4510,0.157639148300336,-3666
"OK","Kiowa","40075",1101,2309,0.322873900293255,-1208
"OK","Latimer","40077",1169,2620,0.308524676695698,-1451
"OK","LeFlore","40079",4658,11172,0.294251421351864,-6514
"OK","Lincoln","40081",3265,9542,0.254938705395487,-6277
"OK","Logan","40083",4686,12297,0.275922981805335,-7611
"OK","Love","40085",1034,2436,0.297982708933718,-1402
"OK","Major","40093",446,2700,0.141767323585505,-2254
"OK","Marshall","40095",1396,3744,0.2715953307393,-2348
"OK","Mayes","40097",4822,9634,0.333563918096292,-4812
"OK","McClain","40087",3191,11108,0.223162458913211,-7917
"OK","McCurtain","40089",2440,7633,0.242231708527747,-5193
"OK","McIntosh","40091",2767,4498,0.38086717136958,-1731
"OK","Murray","40099",1540,3606,0.299261562378546,-2066
"OK","Muskogee","40101",9943,13392,0.426098135847439,-3449
"OK","Noble","40103",1142,3484,0.246865542585387,-2342
"OK","Nowata","40105",1244,2832,0.305201177625123,-1588
"OK","Okfuskee","40107",1251,2328,0.34953897736798,-1077
"OK","Oklahoma","40109",106812,149525,0.41668584714653,-42713
"OK","Okmulgee","40111",5416,7712,0.412553321145643,-2296
"OK","Osage","40113",6695,11218,0.373750907162396,-4523
"OK","Ottawa","40115",3508,6465,0.35174972425549,-2957
"OK","Pawnee","40117",1813,4228,0.300115874855156,-2415
"OK","Payne","40119",9193,16467,0.358261886204209,-7274
"OK","Pittsburg","40121",4813,10785,0.308565200666752,-5972
"OK","Pontotoc","40123",3934,8921,0.306028782574874,-4987
"OK","Pottawatomie","40125",7182,16240,0.306634787806336,-9058
"OK","Pushmataha","40127",1043,3087,0.252542372881356,-2044
"OK","Roger Mills","40129",272,1402,0.162485065710872,-1130
"OK","Rogers","40131",9146,27531,0.24936608773891,-18385
"OK","Seminole","40133",2597,4852,0.348637400993422,-2255
"OK","Sequoyah","40135",4193,9573,0.304591021356966,-5380
"OK","Stephens","40137",3939,12907,0.2338240531877,-8968
"OK","Texas","40139",854,4908,0.148212426240889,-4054
"OK","Tillman","40141",906,1813,0.333210739242368,-907
"OK","Tulsa","40143",82633,144908,0.36315653003195,-62275
"OK","Wagoner","40145",7773,20848,0.271583802103351,-13075
"OK","Washington","40147",5532,15667,0.260955705457805,-10135
"OK","Washita","40149",821,3482,0.190797118289565,-2661
"OK","Woods","40151",670,2725,0.197349042709867,-2055
"OK","Woodward","40153",1129,5936,0.159801840056617,-4807
"OR","Baker","41001",2364,5692,0.293445878848064,-3328
"OR","Benton","41003",27662,14922,0.649586699229758,12740
"OR","Clackamas","41005",94159,87647,0.517909199916394,6512
"OR","Clatsop","41007",9616,7101,0.575222827062272,2515
"OR","Columbia","41009",11843,10645,0.526636428317325,1198
"OR","Coos","41011",12628,14398,0.467253755642714,-1770
"OR","Crook","41013",3081,6769,0.312791878172589,-3688
"OR","Curry","41015",4611,6577,0.412138005005363,-1966
"OR","Deschutes","41017",34985,40670,0.462428127684885,-5685
"OR","Douglas","41019",17032,30588,0.357664846703066,-13556
"OR","Gilliam","41021",371,637,0.368055555555556,-266
"OR","Grant","41023",834,2848,0.226507332971211,-2014
"OR","Harney","41025",829,2599,0.241831971995333,-1770
"OR","Hood River","41027",5977,3400,0.63741068572038,2577
"OR","Jackson","41029",42341,46974,0.47406370710407,-4633
"OR","Jefferson","41031",3238,4576,0.414384438187868,-1338
"OR","Josephine","41033",14929,23636,0.387112666925969,-8707
"OR","Klamath","41035",8140,18654,0.303799358065239,-10514
"OR","Lake","41037",769,2801,0.215406162464986,-2032
"OR","Lane","41039",99891,60979,0.620942375831417,38912
"OR","Lincoln","41041",13277,8623,0.606255707762557,4654
"OR","Linn","41043",19893,28482,0.41122480620155,-8589
"OR","Malheur","41045",2701,6751,0.285759627592044,-4050
"OR","Marion","41047",54337,58435,0.481830596247295,-4098
"OR","Morrow","41049",1189,2524,0.320226232157285,-1335
"OR","Multnomah","41051",265938,73306,0.783913643277405,192632
"OR","Polk","41053",15761,17377,0.475617116301527,-1616
"OR","Sherman","41055",317,677,0.318913480885312,-360
"OR","Tillamook","41057",6249,5670,0.524288950415303,579
"OR","Umatilla","41059",8499,15425,0.35524995820097,-6926
"OR","Union","41061",3943,7608,0.341355726776902,-3665
"OR","Wallowa","41063",1252,2796,0.309288537549407,-1544
"OR","Wasco","41065",5066,5152,0.495791740066549,-86
"OR","Washington","41067",124431,86551,0.589770691338598,37880
"OR","Wheeler","41069",262,542,0.325870646766169,-280
"OR","Yamhill","41071",18906,21711,0.465470123347367,-2805
"PA","Adams","42001",14893,26490,0.359882077181451,-11597
"PA","Allegheny","42003",348151,259304,0.573130519956211,88847
"PA","Armstrong","42005",8694,19231,0.311333930170098,-10537
"PA","Beaver","42007",36833,42118,0.466529872959177,-5285
"PA","Bedford","42009",4730,16509,0.222703517114742,-11779
"PA","Berks","42011",79895,80857,0.497007813277595,-962
"PA","Blair","42013",15516,31500,0.330015313935681,-15984
"PA","Bradford","42015",8291,13827,0.374853060855412,-5536
"PA","Bucks","42017",159598,155876,0.505899059827434,3722
"PA","Butler","42019",28385,59416,0.323287889659571,-31031
"PA","Cambria","42021",23181,33464,0.409232942007238,-10283
"PA","Cameron","42023",677,1264,0.348789283874292,-587
"PA","Carbon","42025",11040,12710,0.464842105263158,-1670
"PA","Centre","42027",33677,33697,0.499851574791463,-20
"PA","Chester","42029",122232,123280,0.497865684773046,-1048
"PA","Clarion","42031",4731,10228,0.316264456180226,-5497
"PA","Clearfield","42033",11093,20303,0.353325264364887,-9210
"PA","Clinton","42035",5503,6941,0.442221150755384,-1438
"PA","Columbia","42037",10424,13445,0.436717080732331,-3021
"PA","Crawford","42039",13024,19497,0.400479690046432,-6473
"PA","Cumberland","42041",43983,64365,0.405941964780153,-20382
"PA","Dauphin","42043",64209,56838,0.530446851223079,7371
"PA","Delaware","42045",164805,105270,0.610219383504582,59535
"PA","Elk","42047",5144,7099,0.420158457894307,-1955
"PA","Erie","42049",65136,46102,0.585555295852137,19034
"PA","Fayette","42051",21841,25845,0.45801702805855,-4004
"PA","Forest","42053",894,1381,0.392967032967033,-487
"PA","Franklin","42055",18910,43072,0.305088574102159,-24162
"PA","Fulton","42057",1297,4780,0.213427678130657,-3483
"PA","Greene","42059",5564,7985,0.410657613107978,-2421
"PA","Huntingdon","42061",5383,11953,0.310509921550531,-6570
"PA","Indiana","42063",14403,21187,0.404692329305985,-6784
"PA","Jefferson","42065",4535,12288,0.269571420079653,-7753
"PA","Juniata","42067",2533,6821,0.270793243532179,-4288
"PA","Lackawanna","42069",61309,34730,0.638376076385635,26579
"PA","Lancaster","42071",87108,129364,0.402398462618722,-42256
"PA","Lawrence","42073",17427,20915,0.454514631474623,-3488
"PA","Lebanon","42075",18975,34010,0.358120222704539,-15035
"PA","Lehigh","42077",77029,66091,0.538212688652879,10938
"PA","Luzerne","42079",63974,57969,0.524622159533553,6005
"PA","Lycoming","42081",15104,30490,0.331271658551564,-15386
"PA","McKean","42083",5260,9494,0.356513487867697,-4234
"PA","Mercer","42085",23082,24304,0.487105896256278,-1222
"PA","Mifflin","42087",4259,11893,0.263682516097078,-7634
"PA","Monroe","42089",33431,25100,0.571167415557568,8331
"PA","Montgomery","42091",227561,169903,0.572532355131534,57658
"PA","Montour","42093",3026,4636,0.394936048029235,-1610
"PA","Northampton","42095",65014,59242,0.523226242595931,5772
"PA","Northumberland","42097",12392,18516,0.400931797592856,-6124
"PA","Perry","42099",5430,12511,0.302658714675882,-7081
"PA","Philadelphia","42101",557024,91840,0.858460324505598,465184
"PA","Pike","42103",10170,12713,0.444434733208058,-2543
"PA","Potter","42105",1892,5199,0.266817092088563,-3307
"PA","Schuylkill","42107",24453,32156,0.431963115405678,-7703
"PA","Snyder","42109",4672,10050,0.317348186387719,-5378
"PA","Somerset","42111",9420,23935,0.282416429320941,-14515
"PA","Sullivan","42113",1028,1859,0.356078974714236,-831
"PA","Susquehanna","42115",6891,10735,0.390956541472824,-3844
"PA","Tioga","42117",5053,10599,0.322834142601584,-5546
"PA","Union","42119",6063,9863,0.380698229310561,-3800
"PA","Venango","42121",7469,12928,0.366181301171741,-5459
"PA","Warren","42123",6768,9415,0.418216647098807,-2647
"PA","Washington","42125",38503,50455,0.432822230715619,-11952
"PA","Wayne","42127",8138,12531,0.393729740190624,-4393
"PA","Westmoreland","42129",63380,103429,0.379955517987639,-40049
"PA","Wyoming","42131",4812,6189,0.437414780474502,-1377
"PA","York","42133",72126,111576,0.392625012248097,-39450
"RI","Barrington","94400001",5546,3825,0.591825845694163,1721
"RI","Bristol","94400002",6341,3704,0.631259333001493,2637
"RI","Burrillville","94400003",3660,3039,0.546350201522615,621
"RI","Central Falls","94400004",3390,509,0.869453706078482,2881
"RI","Charlestown","94400005",2433,1613,0.601334651507662,820
"RI","Coventry","94400006",9091,6956,0.566523337695519,2135
"RI","Cranston","94400007",21324,12978,0.621654714010845,8346
"RI","Cumberland","94400008",9277,7096,0.566603554632627,2181
"RI","East Greenwich","94400009",3645,3524,0.50843911284698,121
"RI","East Providence","94400010",14050,5740,0.709954522486104,8310
"RI","Exeter","94400011",1672,1472,0.531806615776081,200
"RI","Foster","94400012",1279,1088,0.54034643008027,191
"RI","Glocester","94400013",2523,2405,0.511972402597403,118
"RI","Hopkinton","94400014",2044,1521,0.573352033660589,523
"RI","Jamestown","94400015",1985,1209,0.621477770820288,776
"RI","Johnston","94400016",7493,5407,0.580852713178295,2086
"RI","Lincoln","94400017",5754,4608,0.555298204979734,1146
"RI","Little Compton","94400018",1211,904,0.5725768321513,307
"RI","Middletown","94400019",4282,2770,0.607203630175837,1512
"RI","Narragansett","94400020",4229,3193,0.569792508757747,1036
"RI","New Shoreham","94400022",664,276,0.706382978723404,388
"RI","Newport","94400021",6145,2942,0.676240783536921,3203
"RI","North Kingstown","94400023",7828,6445,0.548448118825755,1383
"RI","North Providence","94400024",9592,5386,0.64040592869542,4206
"RI","North Smithfield","94400025",3046,2847,0.516884439165111,199
"RI","Pawtucket","94400026",18042,5219,0.775633033833455,12823
"RI","Portsmouth","94400027",5009,4159,0.546356893542757,850
"RI","Providence","94400028",41588,6877,0.858103786237491,34711
"RI","Richmond","94400029",1925,1503,0.561551925320887,422
"RI","Scituate","94400030",2454,2826,0.464772727272727,-372
"RI","Smithfield","94400031",4875,4359,0.527940220922677,516
"RI","South Kingstown","94400032",8572,4705,0.645627777359343,3867
"RI","Tiverton","94400033",4875,4359,0.527940220922677,516
"RI","Warren","94400034",3056,1687,0.644317942230656,1369
"RI","Warwick","94400035",24403,15001,0.619302608872196,9402
"RI","West Greenwich","94400037",1202,1192,0.502088554720134,10
"RI","West Warwick","94400038",6625,4113,0.616967777984727,2512
"RI","Westerly","94400036",5537,3938,0.584379947229551,1599
"RI","Woonsocket","94400039",7675,3960,0.659647614954878,3715
"SC","Abbeville","45001",4507,5923,0.432118887823586,-1416
"SC","Aiken","45003",23953,41157,0.367885117493473,-17204
"SC","Allendale","45005",3335,894,0.788602506502719,2441
"SC","Anderson","45007",22315,48493,0.315148005875042,-26178
"SC","Bamberg","45009",4600,2190,0.677466863033873,2410
"SC","Barnwell","45011",5182,4655,0.526786621937583,527
"SC","Beaufort","45013",29775,42580,0.411512680533481,-12805
"SC","Berkeley","45015",24239,35764,0.403963135176575,-11525
"SC","Calhoun","45017",4043,3705,0.521812080536913,338
"SC","Charleston","45019",81027,77248,0.511938082451429,3779
"SC","Cherokee","45021",7219,13306,0.351717417783191,-6087
"SC","Chester","45023",7839,6336,0.553015873015873,1503
"SC","Chesterfield","45025",7942,8488,0.48338405356056,-546
"SC","Clarendon","45027",8967,6890,0.565491581005234,2077
"SC","Colleton","45029",8470,8439,0.500916671595009,31
"SC","Darlington","45031",15452,14429,0.517117901007329,1023
"SC","Dillon","45033",7623,5477,0.581908396946565,2146
"SC","Dorchester","45035",23390,32469,0.418732881003956,-9079
"SC","Edgefield","45037",4965,6511,0.432642035552457,-1546
"SC","Fairfield","45039",7743,3996,0.659596217735753,3747
"SC","Florence","45041",28508,28825,0.497235449043308,-317
"SC","Georgetown","45043",14119,16476,0.461480634090538,-2357
"SC","Greenville","45045",67378,120514,0.358599621058906,-53136
"SC","Greenwood","45047",11884,16290,0.421807340100802,-4406
"SC","Hampton","45049",5814,3310,0.637220517316966,2504
"SC","Horry","45051",36620,66653,0.354594133994364,-30033
"SC","Jasper","45053",5727,4169,0.578718674211803,1558
"SC","Kershaw","45055",10821,15846,0.405782427719654,-5025
"SC","Lancaster","45057",13345,19273,0.40912992826047,-5928
"SC","Laurens","45059",10297,14726,0.411501418694801,-4429
"SC","Lee","45061",5972,2829,0.678559254630156,3143
"SC","Lexington","45063",34007,76392,0.308037210481979,-42385
"SC","Marion","45067",9518,5114,0.650492072170585,4404
"SC","Marlboro","45069",7554,4010,0.653234175025943,3544
"SC","McCormick","45065",2637,2460,0.517363154796939,177
"SC","Newberry","45071",6891,9218,0.427773294431684,-2327
"SC","Oconee","45073",8537,21573,0.283527067419462,-13036
"SC","Orangeburg","45075",30454,11888,0.71923858107789,18566
"SC","Pickens","45077",11122,33385,0.249893275215135,-22263
"SC","Richland","45079",94350,46725,0.668793195108985,47625
"SC","Saluda","45081",3322,5130,0.393043066729768,-1808
"SC","Spartanburg","45083",40920,65951,0.382891523425438,-25031
"SC","Sumter","45085",27550,19266,0.588474025974026,8284
"SC","Union","45087",5748,6566,0.4667857722917,-818
"SC","Williamsburg","45089",11318,4819,0.701369523455413,6499
"SC","York","45091",38757,59149,0.395859293608155,-20392
"SD","Aurora","46003",556,804,0.408823529411765,-248
"SD","Beadle","46005",2881,4230,0.405146955421178,-1349
"SD","Bennett","46007",548,626,0.466780238500852,-78
"SD","Bon Homme","46009",1167,1830,0.389389389389389,-663
"SD","Brookings","46011",5826,6219,0.483686176836862,-393
"SD","Brown","46013",7249,8320,0.465604727342797,-1071
"SD","Brule","46015",824,1499,0.35471373224279,-675
"SD","Buffalo","46017",472,166,0.739811912225705,306
"SD","Butte","46019",1000,3068,0.245821042281219,-2068
"SD","Campbell","46021",153,616,0.198959687906372,-463
"SD","Charles Mix","46023",1482,2229,0.399353274050121,-747
"SD","Clark","46025",713,1067,0.400561797752809,-354
"SD","Clay","46027",2955,2146,0.579298176828073,809
"SD","Codington","46029",4588,6696,0.406593406593407,-2108
"SD","Corson","46031",647,515,0.556798623063683,132
"SD","Custer","46033",1335,3062,0.303616101887651,-1727
"SD","Davison","46035",3042,4754,0.390200102616727,-1712
"SD","Day","46037",1497,1320,0.531416400425985,177
"SD","Deuel","46039",941,1175,0.444706994328923,-234
"SD","Dewey","46041",1207,663,0.645454545454546,544
"SD","Douglas","46043",332,1334,0.199279711884754,-1002
"SD","Edmunds","46045",622,1264,0.329798515376458,-642
"SD","Fall River","46047",1137,2256,0.335101679929266,-1119
"SD","Faulk","46049",331,765,0.302007299270073,-434
"SD","Grant","46051",1493,2034,0.423305925715906,-541
"SD","Gregory","46053",599,1507,0.284425451092118,-908
"SD","Haakon","46055",138,940,0.128014842300557,-802
"SD","Hamlin","46057",921,1803,0.338105726872247,-882
"SD","Hand","46059",575,1242,0.316455696202532,-667
"SD","Hanson","46061",760,1627,0.318391286133222,-867
"SD","Harding","46063",82,638,0.113888888888889,-556
"SD","Hughes","46065",2786,5219,0.348032479700187,-2433
"SD","Hutchinson","46067",923,2451,0.273562537048014,-1528
"SD","Hyde","46069",189,531,0.2625,-342
"SD","Jackson","46071",426,661,0.391904323827047,-235
"SD","Jerauld","46073",452,538,0.456565656565657,-86
"SD","Jones","46075",108,490,0.180602006688963,-382
"SD","Kingsbury","46077",1092,1451,0.429414077860794,-359
"SD","Lake","46079",2724,3419,0.443431548103532,-695
"SD","Lawrence","46081",3973,7025,0.361247499545372,-3052
"SD","Lincoln","46083",7982,13611,0.369656833232992,-5629
"SD","Lyman","46085",605,933,0.393368010403121,-328
"SD","Marshall","46091",1061,889,0.544102564102564,172
"SD","McCook","46087",905,1655,0.353515625,-750
"SD","McPherson","46089",272,921,0.227996647108131,-649
"SD","Meade","46093",2928,7560,0.279176201372998,-4632
"SD","Mellette","46095",375,381,0.496031746031746,-6
"SD","Miner","46097",479,636,0.429596412556054,-157
"SD","Minnehaha","46099",34668,40330,0.462252326728713,-5662
"SD","Moody","46101",1429,1535,0.482118758434548,-106
"SD","Pennington","46103",15122,28229,0.348827016677816,-13107
"SD","Perkins","46105",319,1205,0.209317585301837,-886
"SD","Potter","46107",339,1029,0.24780701754386,-690
"SD","Roberts","46109",2302,1883,0.550059737156511,419
"SD","Sanborn","46111",389,688,0.361188486536676,-299
"SD","Shannon","46113",2922,188,0.939549839228296,2734
"SD","Spink","46115",1300,1670,0.437710437710438,-370
"SD","Stanley","46117",435,1063,0.290387182910547,-628
"SD","Sully","46119",186,611,0.233375156838143,-425
"SD","Todd","46121",1976,498,0.798706548100243,1478
"SD","Tripp","46123",737,1905,0.278955336866011,-1168
"SD","Turner","46125",1411,2715,0.341977702375182,-1304
"SD","Union","46127",2782,4698,0.37192513368984,-1916
"SD","Walworth","46129",671,1731,0.279350541215654,-1060
"SD","Yankton","46135",4208,5463,0.435115293144452,-1255
"SD","Ziebach","46137",439,314,0.583001328021248,125
"TN","Anderson","47001",10112,18941,0.348053557291846,-8829
"TN","Bedford","47003",4207,10026,0.295580692756271,-5819
"TN","Benton","47005",2255,3850,0.369369369369369,-1595
"TN","Bledsoe","47007",1267,3022,0.295406854744696,-1755
"TN","Blount","47009",12925,35417,0.267365851640396,-22492
"TN","Bradley","47011",8035,27417,0.226644477039377,-19382
"TN","Campbell","47013",3327,8602,0.278900159275715,-5275
"TN","Cannon","47015",1560,3308,0.320460147904684,-1748
"TN","Carroll","47017",3475,7219,0.324948569291191,-3744
"TN","Carter","47019",4786,15496,0.235972783749137,-10710
"TN","Cheatham","47021",4656,10266,0.312022517088862,-5610
"TN","Chester","47023",1622,4672,0.257705751509374,-3050
"TN","Claiborne","47025",2433,7617,0.242089552238806,-5184
"TN","Clay","47027",1037,1747,0.372485632183908,-710
"TN","Cocke","47029",2804,8459,0.24895676107609,-5655
"TN","Coffee","47031",5865,13013,0.310679097362009,-7148
"TN","Crockett","47033",1669,3782,0.306182351862044,-2113
"TN","Cumberland","47035",6260,18651,0.251294608807354,-12391
"TN","Davidson","47037",138899,94464,0.595205752411479,44435
"TN","Decatur","47039",1302,2873,0.31185628742515,-1571
"TN","DeKalb","47041",2168,4134,0.34401777213583,-1966
"TN","Dickson","47043",6228,11287,0.355580930630888,-5059
"TN","Dyer","47045",3757,9921,0.274674660038017,-6164
"TN","Fayette","47047",6683,12682,0.345107152078492,-5999
"TN","Fentress","47049",1559,5240,0.229298426239153,-3681
"TN","Franklin","47051",5594,10252,0.353022844881989,-4658
"TN","Gibson","47053",6564,12883,0.337532781405872,-6319
"TN","Giles","47055",3759,6914,0.35219713295231,-3155
"TN","Grainger","47057",1668,5469,0.233711643547709,-3801
"TN","Greene","47059",6216,17234,0.265074626865672,-11018
"TN","Grundy","47061",1637,2502,0.395506160908432,-865
"TN","Hamblen","47063",5229,14515,0.264839951377634,-9286
"TN","Hamilton","47065",58794,79877,0.423981942871978,-21083
"TN","Hancock","47067",475,1527,0.237262737262737,-1052
"TN","Hardeman","47069",5479,4864,0.529730252344581,615
"TN","Hardin","47071",2467,7886,0.238288418815802,-5419
"TN","Hawkins","47073",5086,14376,0.261329770835474,-9290
"TN","Haywood","47075",4567,2960,0.60674903680085,1607
"TN","Henderson","47077",2516,7418,0.25327159251057,-4902
"TN","Henry","47079",4337,8187,0.346295113382306,-3850
"TN","Hickman","47081",2693,4756,0.361525036917707,-2063
"TN","Houston","47083",1400,1579,0.469956361195032,-179
"TN","Humphreys","47085",2904,3829,0.431308480617852,-925
"TN","Jackson","47087",1736,2380,0.421768707482993,-644
"TN","Jefferson","47089",4230,13037,0.244975965714948,-8807
"TN","Johnson","47091",1483,4611,0.243354118805382,-3128
"TN","Knox","47093",57594,106411,0.351172220359135,-48817
"TN","Lake","47095",884,1163,0.431851489985344,-279
"TN","Lauderdale","47097",4010,4616,0.464873637839091,-606
"TN","Lawrence","47099",4237,10770,0.282334910375158,-6533
"TN","Lewis","47101",1445,3116,0.316816487612366,-1671
"TN","Lincoln","47103",3283,9791,0.251109071439498,-6508
"TN","Loudon","47105",5057,16701,0.232420259215001,-11644
"TN","Macon","47111",1552,5259,0.227866686242842,-3707
"TN","Madison","47113",18360,21989,0.455029864432824,-3629
"TN","Marion","47115",3952,6268,0.386692759295499,-2316
"TN","Marshall","47117",3722,6823,0.352963489805595,-3101
"TN","Maury","47119",11819,20698,0.363471414952179,-8879
"TN","McMinn","47107",4603,12958,0.262114913729286,-8355
"TN","McNairy","47109",2643,7010,0.273800890914742,-4367
"TN","Meigs","47121",1163,2728,0.298894885633513,-1565
"TN","Monroe","47123",4368,11717,0.271557351569785,-7349
"TN","Montgomery","47125",24349,30159,0.446705070815293,-5810
"TN","Moore","47127",705,2053,0.255620014503263,-1348
"TN","Morgan","47129",1722,4668,0.269483568075117,-2946
"TN","Obion","47131",3320,8814,0.273611340036262,-5494
"TN","Overton","47133",2802,4772,0.36994982836018,-1970
"TN","Perry","47135",992,1578,0.385992217898833,-586
"TN","Pickett","47137",711,1707,0.294044665012407,-996
"TN","Polk","47139",1856,4108,0.311200536552649,-2252
"TN","Putnam","47141",7793,17242,0.311284202117036,-9449
"TN","Rhea","47143",2625,7793,0.25196774812824,-5168
"TN","Roane","47145",6014,14719,0.290068972169971,-8705
"TN","Robertson","47147",8289,17641,0.319668337832626,-9352
"TN","Rutherford","47149",36400,60829,0.374373900790916,-24429
"TN","Scott","47151",1452,5117,0.221038209773177,-3665
"TN","Sequatchie","47153",1488,3541,0.295883873533506,-2053
"TN","Sevier","47155",7415,25979,0.222045876504761,-18564
"TN","Shelby","47157",232201,135536,0.631432246415237,96665
"TN","Smith","47159",2467,4492,0.354504957608852,-2025
"TN","Stewart","47161",2069,2963,0.411168521462639,-894
"TN","Sullivan","47163",15303,43528,0.260117965018443,-28225
"TN","Sumner","47165",18571,45979,0.287699457784663,-27408
"TN","Tipton","47167",7020,16395,0.299807815502883,-9375
"TN","Trousdale","47169",1238,1610,0.434691011235955,-372
"TN","Unicoi","47171",1909,5028,0.2751910047571,-3119
"TN","Union","47173",1474,4278,0.256258692628651,-2804
"TN","Van Buren","47175",875,1384,0.387339530765826,-509
"TN","Warren","47177",4748,8007,0.372246177969424,-3259
"TN","Washington","47179",14318,32787,0.303959239995754,-18469
"TN","Wayne","47181",1163,4251,0.214813446619874,-3088
"TN","Weakley","47183",3547,8601,0.291982219295357,-5054
"TN","White","47185",2793,6192,0.31085141903172,-3399
"TN","Williamson","47187",24328,68090,0.263238763011535,-43762
"TN","Wilson","47189",14669,36076,0.289072815055671,-21407
"TX","Anderson","48001",3796,12235,0.23679121701703,-8439
"TX","Andrews","48003",794,3636,0.179232505643341,-2842
"TX","Angelina","48005",7833,20301,0.278417573043293,-12468
"TX","Aransas","48007",2703,6829,0.283571128829207,-4126
"TX","Archer","48009",525,3599,0.127303588748788,-3074
"TX","Armstrong","48011",98,828,0.105831533477322,-730
"TX","Atascosa","48013",5128,7451,0.407663566261229,-2323
"TX","Austin","48015",2252,9260,0.195621959694232,-7008
"TX","Bailey","48017",466,1336,0.258601553829079,-870
"TX","Bandera","48019",1859,7423,0.200280112044818,-5564
"TX","Bastrop","48021",9860,14019,0.412915113698229,-4159
"TX","Baylor","48023",267,1297,0.170716112531969,-1030
"TX","Bee","48025",3451,4354,0.442152466367713,-903
"TX","Bell","48027",35315,49369,0.417020924850031,-14054
"TX","Bexar","48029",263871,240519,0.523148753940403,23352
"TX","Blanco","48031",1220,3637,0.251183858348775,-2417
"TX","Borden","48033",32,324,0.0898876404494382,-292
"TX","Bosque","48035",1366,5873,0.188700096698439,-4507
"TX","Bowie","48037",10184,24840,0.290772042028323,-14656
"TX","Brazoria","48039",34327,70684,0.326889563950443,-36357
"TX","Brazos","48041",17440,37152,0.319460726846424,-19712
"TX","Brewster","48043",1765,1975,0.47192513368984,-210
"TX","Briscoe","48045",117,576,0.168831168831169,-459
"TX","Brooks","48047",1886,507,0.788132051817802,1379
"TX","Brown","48049",1904,11894,0.137991013190317,-9990
"TX","Burleson","48051",1705,4671,0.267409033877039,-2966
"TX","Burnet","48053",3672,12828,0.222545454545455,-9156
"TX","Caldwell","48055",4787,6018,0.443035631652013,-1231
"TX","Calhoun","48057",2510,4145,0.377160030052592,-1635
"TX","Callahan","48059",751,4376,0.146479422664326,-3625
"TX","Cameron","48061",49159,24955,0.66328898723588,24204
"TX","Camp","48063",1428,2878,0.331630283325592,-1450
"TX","Carson","48065",292,2450,0.106491611962071,-2158
"TX","Cass","48067",2921,8747,0.250342817963661,-5826
"TX","Castro","48069",630,1470,0.3,-840
"TX","Chambers","48071",2780,11761,0.191183549962176,-8981
"TX","Cherokee","48073",3935,12291,0.242512017749291,-8356
"TX","Childress","48075",320,1665,0.161209068010076,-1345
"TX","Clay","48077",740,4266,0.147822612864563,-3526
"TX","Cochran","48079",256,648,0.283185840707965,-392
"TX","Coke","48081",179,1216,0.12831541218638,-1037
"TX","Coleman","48083",441,3007,0.127900232018561,-2566
"TX","Collin","48085",100754,195933,0.33959694897316,-95179
"TX","Collingsworth","48087",177,962,0.155399473222125,-785
"TX","Colorado","48089",2024,6015,0.2517726085334,-3991
"TX","Comal","48091",11437,39291,0.225457341113389,-27854
"TX","Comanche","48093",890,3940,0.184265010351967,-3050
"TX","Concho","48095",194,793,0.196555217831814,-599
"TX","Cooke","48097",2240,11901,0.158404638992999,-9661
"TX","Coryell","48099",5141,11193,0.314742255418146,-6052
"TX","Cottle","48101",180,553,0.245566166439291,-373
"TX","Crane","48103",275,985,0.218253968253968,-710
"TX","Crockett","48105",480,957,0.334029227557411,-477
"TX","Crosby","48107",639,1132,0.360813099943535,-493
"TX","Culberson","48109",566,294,0.658139534883721,272
"TX","Dallam","48111",253,1248,0.168554297135243,-995
"TX","Dallas","48113",403170,294339,0.578014047130575,108831
"TX","Dawson","48115",1017,2591,0.281873614190687,-1574
"TX","De Witt","48123",1463,5114,0.222441842785464,-3651
"TX","Deaf Smith","48117",1239,3042,0.289418360196216,-1803
"TX","Delta","48119",454,1524,0.229524772497472,-1070
"TX","Denton","48121",79917,156105,0.338599791544856,-76188
"TX","Dickens","48125",216,793,0.214073339940535,-577
"TX","Dimmit","48127",2141,762,0.737512917671374,1379
"TX","Donley","48129",226,1286,0.149470899470899,-1060
"TX","Duval","48131",3331,979,0.772853828306264,2352
"TX","Eastland","48133",970,5443,0.151255262747544,-4473
"TX","Ector","48135",8095,23936,0.252723923698917,-15841
"TX","Edwards","48137",232,641,0.265750286368843,-409
"TX","El Paso","48141",112273,56517,0.665163813022098,55756
"TX","Ellis","48139",13803,39353,0.259669651591542,-25550
"TX","Erath","48143",1965,10325,0.159886086248983,-8360
"TX","Falls","48145",2033,3356,0.377249953609204,-1323
"TX","Fannin","48147",2482,8143,0.2336,-5661
"TX","Fayette","48149",2311,8098,0.222019406283024,-5787
"TX","Fisher","48151",512,1094,0.318804483188045,-582
"TX","Floyd","48153",551,1523,0.265670202507232,-972
"TX","Foard","48155",140,346,0.288065843621399,-206
"TX","Fort Bend","48157",101043,116028,0.465483643600481,-14985
"TX","Franklin","48159",750,3446,0.178741658722593,-2696
"TX","Freestone","48161",1848,5644,0.246663107314469,-3796
"TX","Frio","48163",2376,1559,0.603811944091487,817
"TX","Gaines","48165",535,3484,0.133117690967902,-2949
"TX","Galveston","48167",39162,68594,0.363432198671072,-29432
"TX","Garza","48169",276,1262,0.179453836150845,-986
"TX","Gillespie","48171",2055,10305,0.16626213592233,-8250
"TX","Glasscock","48173",44,526,0.0771929824561404,-482
"TX","Goliad","48175",1127,2294,0.329435837474423,-1167
"TX","Gonzales","48177",1773,4213,0.296191112596057,-2440
"TX","Gray","48179",885,6428,0.121017366333926,-5543
"TX","Grayson","48181",10665,30907,0.256542865390166,-20242
"TX","Gregg","48183",12336,28665,0.300870710470476,-16329
"TX","Grimes","48185",2339,6141,0.275825471698113,-3802
"TX","Guadalupe","48187",15654,32959,0.322012630366363,-17305
"TX","Hale","48189",2228,6417,0.257721226142279,-4189
"TX","Hall","48191",265,832,0.241567912488605,-567
"TX","Hamilton","48193",591,2918,0.168424052436592,-2327
"TX","Hansford","48195",158,1787,0.0812339331619537,-1629
"TX","Hardeman","48197",302,1176,0.204330175913396,-874
"TX","Hardin","48199",3358,17744,0.159131835844944,-14386
"TX","Harris","48201",585451,584866,0.500249932283304,585
"TX","Harrison","48203",8431,17471,0.325496100687206,-9040
"TX","Hartley","48205",183,1700,0.0971853425385024,-1517
"TX","Haskell","48207",551,1422,0.279270146984288,-871
"TX","Hays","48209",25448,31577,0.446260412099956,-6129
"TX","Hemphill","48211",192,1298,0.128859060402685,-1106
"TX","Henderson","48213",6094,21202,0.223256154747948,-15108
"TX","Hidalgo","48215",97879,39786,0.710994079831475,58093
"TX","Hill","48217",2745,9128,0.231196833150846,-6383
"TX","Hockley","48219",1482,5543,0.210960854092527,-4061
"TX","Hood","48221",3829,18341,0.172710870545783,-14512
"TX","Hopkins","48223",2775,9834,0.220080894599096,-7059
"TX","Houston","48225",2235,5839,0.276814466187763,-3604
"TX","Howard","48227",1042,4032,0.205360662199448,-2990
"TX","Hudspeth","48229",379,471,0.445882352941176,-92
"TX","Hunt","48231",6658,20976,0.240935079973945,-14318
"TX","Hutchinson","48233",1042,6797,0.132925117999745,-5755
"TX","Irion","48235",112,668,0.143589743589744,-556
"TX","Jack","48237",303,2580,0.105098855359001,-2277
"TX","Jackson","48239",1068,3903,0.214846107423054,-2835
"TX","Jasper","48241",3402,9924,0.255290409725349,-6522
"TX","Jeff Davis","48243",440,717,0.380293863439931,-277
"TX","Jefferson","48245",44626,43214,0.508037340619308,1412
"TX","Jim Hogg","48247",1301,356,0.785153892576946,945
"TX","Jim Wells","48249",6492,4595,0.585550644899432,1897
"TX","Johnson","48251",10481,37609,0.217945518818881,-27128
"TX","Jones","48253",1225,4258,0.223417836950575,-3033
"TX","Karnes","48255",1324,2823,0.319266939956595,-1499
"TX","Kaufman","48257",9451,24804,0.275901328273245,-15353
"TX","Kendall","48259",3035,14467,0.173408753285339,-11432
"TX","Kenedy","48261",82,83,0.496969696969697,-1
"TX","Kent","48263",66,334,0.165,-268
"TX","Kerr","48265",4325,17225,0.200696055684455,-12900
"TX","Kimble","48267",217,1667,0.115180467091295,-1450
"TX","King","48269",5,139,0.0347222222222222,-134
"TX","Kinney","48271",522,880,0.372325249643367,-358
"TX","Kleberg","48273",4752,4056,0.539509536784741,696
"TX","Knox","48275",332,1160,0.222520107238606,-828
"TX","La Salle","48283",965,669,0.590575275397797,296
"TX","La Vaca","48285",1427,6788,0.173706634205721,-5361
"TX","Lamar","48277",4173,12814,0.245658444693001,-8641
"TX","Lamb","48279",998,3056,0.246176615688209,-2058
"TX","Lampasas","48281",1457,5583,0.206960227272727,-4126
"TX","Lee","48287",1630,4504,0.265731985653733,-2874
"TX","Leon","48289",1061,5812,0.154372180998109,-4751
"TX","Liberty","48291",5196,17304,0.230933333333333,-12108
"TX","Limestone","48293",2208,5288,0.294557097118463,-3080
"TX","Lipscomb","48295",119,1044,0.102321582115219,-925
"TX","Live Oak","48297",915,3153,0.224926253687316,-2238
"TX","Llano","48299",1818,7560,0.193857965451056,-5742
"TX","Loving","48301",9,54,0.142857142857143,-45
"TX","Lubbock","48303",26088,63133,0.292397529729548,-37045
"TX","Lynn","48305",464,1377,0.252036936447583,-913
"TX","Madison","48313",964,3028,0.241482965931864,-2064
"TX","Marion","48315",1487,2730,0.35262034621769,-1243
"TX","Martin","48317",247,1338,0.15583596214511,-1091
"TX","Mason","48319",380,1562,0.1956745623069,-1182
"TX","Matagorda","48321",3972,8026,0.331055175862644,-4054
"TX","Maverick","48323",8302,2171,0.792705051083739,6131
"TX","McCulloch","48307",537,2419,0.181664411366712,-1882
"TX","McLennan","48309",25688,47885,0.349149823984342,-22197
"TX","McMullen","48311",67,436,0.133200795228628,-369
"TX","Medina","48325",4760,11016,0.301724137931034,-6256
"TX","Menard","48327",170,663,0.204081632653061,-493
"TX","Midland","48329",8223,35452,0.188277046365197,-27229
"TX","Milam","48331",2632,5478,0.324537607891492,-2846
"TX","Mills","48333",279,1882,0.129106894956039,-1603
"TX","Mitchell","48335",536,1754,0.234061135371179,-1218
"TX","Montague","48337",1116,6539,0.14578706727629,-5423
"TX","Montgomery","48339",32852,137822,0.192483916706704,-104970
"TX","Moore","48341",963,3967,0.195334685598377,-3004
"TX","Morris","48343",1856,3226,0.365210547028729,-1370
"TX","Motley","48345",55,538,0.0927487352445194,-483
"TX","Nacogdoches","48347",6441,13910,0.316495503906442,-7469
"TX","Navarro","48349",4348,10838,0.286316344001054,-6490
"TX","Newton","48351",1721,4399,0.281209150326797,-2678
"TX","Nolan","48353",1216,3277,0.270643222791008,-2061
"TX","Nueces","48355",45666,48779,0.483519508708772,-3113
"TX","Ochiltree","48357",253,2718,0.0851565129585998,-2465
"TX","Oldham","48359",71,786,0.0828471411901984,-715
"TX","Orange","48361",6797,23361,0.225379667086677,-16564
"TX","Palo Pinto","48363",1810,7392,0.196696370354271,-5582
"TX","Panola","48365",2211,7941,0.217789598108747,-5730
"TX","Parker","48367",7804,38980,0.166809165526676,-31176
"TX","Parmer","48369",528,2005,0.208448480063166,-1477
"TX","Pecos","48371",1591,2512,0.387765049963441,-921
"TX","Polk","48373",4836,14019,0.25648369132856,-9183
"TX","Potter","48375",7114,18905,0.273415580921634,-11791
"TX","Presidio","48377",1273,504,0.716375914462577,769
"TX","Rains","48379",754,3265,0.187608857924857,-2511
"TX","Randall","48381",7553,41366,0.154398086633006,-33813
"TX","Reagan","48383",158,676,0.189448441247002,-518
"TX","Real","48385",277,1236,0.183079973562459,-959
"TX","Red River","48387",1482,3549,0.294573643410853,-2067
"TX","Reeves","48389",1649,1185,0.581863091037403,464
"TX","Refugio","48391",998,1659,0.375611592021076,-661
"TX","Roberts","48393",25,408,0.0577367205542725,-383
"TX","Robertson","48395",2792,4416,0.387347391786903,-1624
"TX","Rockwall","48397",8112,27098,0.230389094007384,-18986
"TX","Runnels","48399",517,3103,0.142817679558011,-2586
"TX","Rusk","48401",4451,13924,0.242231292517007,-9473
"TX","Sabine","48403",806,3726,0.177846425419241,-2920
"TX","San Augustine","48405",1193,2469,0.325778263244129,-1276
"TX","San Jacinto","48407",2410,7105,0.253284287966369,-4695
"TX","San Patricio","48409",7854,11994,0.395707376058041,-4140
"TX","San Saba","48411",323,1905,0.144973070017953,-1582
"TX","Schleicher","48413",220,781,0.21978021978022,-561
"TX","Scurry","48415",837,4121,0.168818071803146,-3284
"TX","Shackelford","48417",131,1218,0.0971089696071164,-1087
"TX","Shelby","48419",2318,6870,0.252285589899869,-4552
"TX","Sherman","48421",121,908,0.117589893100097,-787
"TX","Smith","48423",22101,61858,0.263235626913136,-39757
"TX","Somervell","48425",609,2858,0.175656186905105,-2249
"TX","Starr","48427",10248,1540,0.869358669833729,8708
"TX","Stephens","48429",475,2891,0.141117052881759,-2416
"TX","Sterling","48431",31,459,0.063265306122449,-428
"TX","Stonewall","48433",160,507,0.239880059970015,-347
"TX","Sutton","48435",369,1110,0.249492900608519,-741
"TX","Swisher","48437",579,1654,0.259292431706225,-1075
"TX","Tarrant","48439",252789,348686,0.420281807223908,-95897
"TX","Taylor","48441",9725,32853,0.228404340269623,-23128
"TX","Terrell","48443",184,358,0.339483394833948,-174
"TX","Terry","48445",1059,2602,0.28926522807976,-1543
"TX","Throckmorton","48447",109,700,0.134734239802225,-591
"TX","Titus","48449",2638,6062,0.303218390804598,-3424
"TX","Tom Green","48451",9246,26749,0.256869009584665,-17503
"TX","Travis","48453",231540,139503,0.624024708726482,92037
"TX","Trinity","48455",1614,4537,0.262396358315721,-2923
"TX","Tyler","48457",1659,5889,0.219793322734499,-4230
"TX","Upshur","48459",2953,11948,0.198174619153077,-8995
"TX","Upton","48461",332,952,0.258566978193146,-620
"TX","Uvalde","48463",3824,4526,0.457964071856287,-702
"TX","Val Verde","48465",6267,5612,0.527569660745854,655
"TX","Van Zandt","48467",3083,15790,0.163355057489535,-12707
"TX","Victoria","48469",8795,19684,0.308824045788125,-10889
"TX","Walker","48471",5283,9569,0.355709668731484,-4286
"TX","Waller","48473",6401,9158,0.411401761038627,-2757
"TX","Ward","48475",836,2364,0.26125,-1528
"TX","Washington","48477",3378,10850,0.237419173460782,-7472
"TX","Webb","48479",37592,11074,0.77244893765668,26518
"TX","Wharton","48481",4235,9750,0.302824454772971,-5515
"TX","Wheeler","48483",232,1878,0.109952606635071,-1646
"TX","Wichita","48485",10490,29756,0.260647020821945,-19266
"TX","Wilbarger","48487",971,2956,0.247262541380188,-1985
"TX","Willacy","48489",3595,1415,0.717564870259481,2180
"TX","Williamson","48491",61812,96910,0.389435616990713,-35098
"TX","Wilson","48493",4819,12205,0.283070958646617,-7386
"TX","Winkler","48495",398,1331,0.230190861769809,-933
"TX","Wise","48497",3219,17178,0.157817326077364,-13959
"TX","Wood","48499",3052,14317,0.175715354942714,-11265
"TX","Yoakum","48501",409,1698,0.194114855244423,-1289
"TX","Young","48503",992,6225,0.137453235416378,-5233
"TX","Zapata","48505",2517,993,0.717094017094017,1524
"TX","Zavala","48507",3042,574,0.841261061946903,2468
"UT","Beaver","49001",341,2153,0.13672814755413,-1812
"UT","Box Elder","49003",1830,15969,0.102814764874431,-14139
"UT","Cache","49005",5434,30818,0.149895178197065,-25384
"UT","Carbon","49007",2204,4834,0.313157146916738,-2630
"UT","Daggett","49009",91,399,0.185714285714286,-308
"UT","Davis","49011",20417,90030,0.184857895642254,-69613
"UT","Duchesne","49013",570,5608,0.0922628682421496,-5038
"UT","Emery","49015",569,3743,0.1319573283859,-3174
"UT","Garfield","49017",306,1811,0.144544166273028,-1505
"UT","Grand","49019",1678,1917,0.466759388038943,-239
"UT","Iron","49021",1720,11172,0.133416071982625,-9452
"UT","Juab","49023",436,3400,0.113660062565172,-2964
"UT","Kane","49025",718,2463,0.225715183904433,-1745
"UT","Millard","49027",424,4421,0.0875128998968008,-3997
"UT","Morgan","49029",386,3910,0.0898510242085661,-3524
"UT","Piute","49031",74,696,0.0961038961038961,-622
"UT","Rich","49033",83,907,0.0838383838383838,-824
"UT","Salt Lake","49035",132686,198739,0.400350003771592,-66053
"UT","San Juan","49037",2062,3006,0.406866614048934,-944
"UT","Sanpete","49039",889,7767,0.102703327171904,-6878
"UT","Sevier","49041",701,6961,0.0914904724614983,-6260
"UT","Summit","49043",7656,8464,0.474937965260546,-808
"UT","Tooele","49045",3794,12240,0.236622177872022,-8446
"UT","Uintah","49047",962,10001,0.0877497035482988,-9039
"UT","Utah","49049",15791,142337,0.0998621370029343,-126546
"UT","Wasatch","49051",2097,6852,0.234327857861214,-4755
"UT","Washington","49053",7762,41104,0.158842549011583,-33342
"UT","Wayne","49055",213,1087,0.163846153846154,-874
"UT","Weber","49057",17569,48938,0.264167681597426,-31369
"VA","Accomack","51001",7653,8212,0.482382603214623,-559
"VA","Albemarle","51003",29712,23263,0.560868334119868,6449
"VA","Alexandria","51510",52434,20205,0.721843637715277,32229
"VA","Alleghany","51005",3403,3595,0.486281794798514,-192
"VA","Amelia","51007",2488,4324,0.365237815619495,-1836
"VA","Amherst","51009",5898,8865,0.399512294249136,-2967
"VA","Appomattox","51011",2453,5340,0.31476966508405,-2887
"VA","Arlington","51013",81178,34433,0.702165018899586,46745
"VA","Augusta","51015",9448,23614,0.285766136349888,-14166
"VA","Bath","51017",894,1274,0.412361623616236,-380
"VA","Bedford","51019",10925,29281,0.271725613092573,-18356
"VA","Bedford City","51515",1225,1527,0.445130813953488,-302
"VA","Bland","51021",735,2144,0.255296978117402,-1409
"VA","Botetourt","51023",5449,12471,0.304073660714286,-7022
"VA","Bristol","51520",2487,4776,0.3424204874019,-2289
"VA","Brunswick","51025",4993,2965,0.627418949484795,2028
"VA","Buchanan","51027",3094,6436,0.324658971668416,-3342
"VA","Buckingham","51029",3747,3569,0.512165117550574,178
"VA","Buena Vista","51530",919,1564,0.370116794200564,-645
"VA","Campbell","51031",7591,17687,0.300300656697524,-10096
"VA","Caroline","51033",7258,6148,0.541399373414889,1110
"VA","Carroll","51035",3500,8351,0.295333727111636,-4851
"VA","Charles City","51036",2772,1396,0.665067178502879,1376
"VA","Charlotte","51037",2502,3311,0.430414587992431,-809
"VA","Charlottesville","51540",16267,4801,0.772118853237137,11466
"VA","Chesapeake","51550",54999,53845,0.505301164970049,1154
"VA","Chesterfield","51041",78954,91174,0.464085864760651,-12220
"VA","Clarke","51043",3237,4295,0.429766330323951,-1058
"VA","Colonial Heights","51570",2541,5937,0.299716914366596,-3396
"VA","Covington","51580",1319,975,0.574978204010462,344
"VA","Craig","51045",830,1757,0.320834943950522,-927
"VA","Culpeper","51047",8263,11549,0.417070462346053,-3286
"VA","Cumberland","51049",2422,2538,0.488306451612903,-116
"VA","Danville","51590",12215,7756,0.611636873466527,4459
"VA","Dickenson","51051",2472,4274,0.366439371479395,-1802
"VA","Dinwiddie","51053",6425,6769,0.486963771411248,-344
"VA","Emporia","51595",1793,886,0.669279581933557,907
"VA","Essex","51057",3009,2602,0.53626804491178,407
"VA","Fairfax","51059",260835,173786,0.60014357336622,87049
"VA","Fairfax City","51600",6636,4762,0.582207404807861,1874
"VA","Falls Church","51610",5006,2141,0.700433748425913,2865
"VA","Fauquier","51061",13891,20955,0.398639729093727,-7064
"VA","Floyd","51063",2732,4671,0.369039578549237,-1939
"VA","Fluvanna","51065",5885,6678,0.468439067101807,-793
"VA","Franklin","51067",9082,16685,0.352466332906431,-7603
"VA","Franklin City","51620",2830,1496,0.654184003698567,1334
"VA","Frederick","51069",12683,22851,0.356925761242753,-10168
"VA","Fredericksburg","51630",7114,4054,0.636998567335244,3060
"VA","Galax","51640",900,1332,0.403225806451613,-432
"VA","Giles","51071",2730,4660,0.369418132611637,-1930
"VA","Gloucester","51073",6764,12137,0.357864663245331,-5373
"VA","Goochland","51075",4676,8448,0.356293812861932,-3772
"VA","Grayson","51077",2094,4801,0.303698332124728,-2707
"VA","Greene","51079",3284,5558,0.37140918344266,-2274
"VA","Greensville","51081",3135,1766,0.639665374413385,1369
"VA","Halifax","51083",7760,8699,0.471474573181846,-939
"VA","Hampton","51650",51733,19193,0.729394016298678,32540
"VA","Hanover","51085",18283,39920,0.314124701475869,-21637
"VA","Harrisonburg","51660",8650,6564,0.56855527803339,2086
"VA","Henrico","51087",89116,70235,0.559243431167674,18881
"VA","Henry","51089",10312,13980,0.424501893627532,-3668
"VA","Highland","51091",459,924,0.331887201735358,-465
"VA","Hopewell","51670",5178,3737,0.580818844643859,1441
"VA","Isle of Wight","51093",8754,11797,0.42596467325191,-3043
"VA","James City","51095",17854,22830,0.438845737882214,-4976
"VA","King and Queen","51097",1743,1863,0.483361064891847,-120
"VA","King George","51099",4476,6603,0.404007581911725,-2127
"VA","King William","51101",3326,5445,0.379204195644738,-2119
"VA","Lancaster","51103",3144,3749,0.456114899173074,-605
"VA","Lee","51105",2593,6845,0.274740411104047,-4252
"VA","Lexington","51678",1484,1146,0.56425855513308,338
"VA","Loudoun","51107",81900,74794,0.52267476738101,7106
"VA","Louisa","51109",6949,9207,0.430118841297351,-2258
"VA","Lunenburg","51111",2684,2969,0.474792145763312,-285
"VA","Lynchburg","51680",15905,19752,0.446055472978658,-3847
"VA","Madison","51113",2637,3864,0.405629903091832,-1227
"VA","Manassas","51683",8478,6463,0.567431898801954,2015
"VA","Manassas Park","51685",2873,1696,0.628802801488291,1177
"VA","Martinsville","51690",3855,2312,0.625101345873196,1543
"VA","Mathews","51115",1807,3488,0.341265344664778,-1681
"VA","Mecklenburg","51117",6786,7855,0.463492930810737,-1069
"VA","Middlesex","51119",2370,3619,0.395725496744031,-1249
"VA","Montgomery","51121",19903,20006,0.498709564258689,-103
"VA","Nelson","51125",4171,3944,0.513986444855206,227
"VA","New Kent","51127",3555,7246,0.329136191093417,-3691
"VA","Newport News","51700",50990,27224,0.651929322116245,23766
"VA","Norfolk","51710",55654,21366,0.72259153466632,34288
"VA","Northampton","51131",3737,2676,0.582722594729456,1061
"VA","Northumberland","51133",3186,4308,0.425140112089672,-1122
"VA","Norton","51720",566,895,0.387405886379192,-329
"VA","Nottoway","51135",3344,3409,0.495187324152229,-65
"VA","Orange","51137",6870,9244,0.426337346406851,-2374
"VA","Page","51139",3724,6344,0.369884783472388,-2620
"VA","Patrick","51141",2417,5622,0.300659285980843,-3205
"VA","Petersburg","51730",14377,1526,0.904043262277558,12851
"VA","Pittsylvania","51143",10855,19275,0.360272153999336,-8420
"VA","Poquoson","51735",1679,5312,0.240165927621227,-3633
"VA","Portsmouth","51740",28994,12407,0.700321248279027,16587
"VA","Powhatan","51145",4066,11192,0.266483156376983,-7126
"VA","Prince Edward","51147",5132,3952,0.564949361514751,1180
"VA","Prince George","51149",7671,9350,0.45067857352682,-1679
"VA","Prince William","51153",103161,74371,0.581083973593493,28790
"VA","Pulaski","51155",5287,8917,0.372219093213179,-3630
"VA","Radford","51750",2732,2520,0.52018278750952,212
"VA","Rappahannock","51157",1971,2307,0.460729312762973,-336
"VA","Richmond","51159",1574,2160,0.421531869309052,-586
"VA","Richmond City","51760",71037,19732,0.782613006643237,51305
"VA","Roanoke","51161",19589,33344,0.370071599947103,-13755
"VA","Roanoke City","51770",22179,14116,0.611075905772145,8063
"VA","Rockbridge","51163",4087,5898,0.409313970956435,-1811
"VA","Rockingham","51165",10059,24173,0.293847861649918,-14114
"VA","Russell","51167",3716,8177,0.312452703270832,-4461
"VA","Salem","51775",4756,7289,0.394852635948526,-2533
"VA","Scott","51169",2395,7439,0.243542810656905,-5044
"VA","Shenandoah","51171",6462,12526,0.340320202232989,-6064
"VA","Smyth","51173",4169,8376,0.332323634914308,-4207
"VA","Southampton","51175",4437,4733,0.483860414394766,-296
"VA","Spotsylvania","51177",25150,31818,0.44147591630389,-6668
"VA","Stafford","51179",27130,32429,0.455514699709532,-5299
"VA","Staunton","51790",5710,5257,0.520652867693991,453
"VA","Suffolk","51800",24194,17778,0.576431906985609,6416
"VA","Surry","51181",2574,1671,0.606360424028269,903
"VA","Sussex","51183",3350,2021,0.623719977657792,1329
"VA","Tazewell","51185",3661,13843,0.209152193784278,-10182
"VA","Virginia Beach","51810",94163,99107,0.487209603145858,-4944
"VA","Warren","51187",6449,9865,0.395304646316048,-3416
"VA","Washington","51191",7076,18141,0.280604354205496,-11065
"VA","Waynesboro","51820",3836,4789,0.444753623188406,-953
"VA","Westmoreland","51193",4155,4116,0.502357635110627,39
"VA","Williamsburg","51830",4901,2678,0.646655231560892,2223
"VA","Winchester","51840",5089,4943,0.507276714513557,146
"VA","Wise","51195",3751,11041,0.253583017847485,-7290
"VA","Wythe","51197",3782,8324,0.312407070873947,-4542
"VA","York","51199",13165,20182,0.394788136863886,-7017
"VT","Addison","95000001",386,336,0.534626038781163,50
"VT","Albany","95000002",290,149,0.660592255125285,141
"VT","Alburg","95000003",591,314,0.653038674033149,277
"VT","Andover","95000004",187,118,0.613114754098361,69
"VT","Arlington","95000005",749,468,0.61544782251438,281
"VT","Athens","95000006",84,55,0.60431654676259,29
"VT","Bakersfield","95000007",386,190,0.670138888888889,196
"VT","Baltimore","95000008",63,46,0.577981651376147,17
"VT","Barnard","95000009",355,184,0.658627087198516,171
"VT","Barnet","95000010",582,363,0.615873015873016,219
"VT","Barre","95000011",1946,1048,0.649966599866399,898
"VT","Barre Town","95000012",2127,1734,0.550893550893551,393
"VT","Barton","95000013",671,390,0.632422243166824,281
"VT","Belvidere","95000014",82,57,0.589928057553957,25
"VT","Bennington","95000015",4503,1753,0.719789002557545,2750
"VT","Benson","95000016",301,159,0.654347826086957,142
"VT","Berkshire","95000017",342,219,0.609625668449198,123
"VT","Berlin","95000018",795,426,0.651105651105651,369
"VT","Bethel","95000019",646,306,0.678571428571429,340
"VT","Bloomfield","95000020",58,40,0.591836734693878,18
"VT","Bolton","95000021",433,161,0.728956228956229,272
"VT","Bradford","95000022",754,416,0.644444444444444,338
"VT","Braintree","95000023",358,185,0.659300184162063,173
"VT","Brandon","95000024",1204,568,0.679458239277652,636
"VT","Brattleboro","95000025",4621,915,0.834718208092486,3706
"VT","Bridgewater","95000026",317,158,0.667368421052632,159
"VT","Bridport","95000027",340,277,0.551053484602917,63
"VT","Brighton","95000028",299,223,0.5727969348659,76
"VT","Bristol","95000029",1238,507,0.70945558739255,731
"VT","Brookfield","95000030",456,216,0.678571428571429,240
"VT","Brookline","95000031",179,76,0.701960784313725,103
"VT","Brownington","95000032",229,150,0.604221635883905,79
"VT","Brunswick","95000033",38,22,0.633333333333333,16
"VT","Burke","95000034",455,287,0.613207547169811,168
"VT","Burlington","95000035",14322,2591,0.846804233429906,11731
"VT","Cabot","95000036",487,221,0.687853107344633,266
"VT","Calais","95000037",753,208,0.783558792924037,545
"VT","Cambridge","95000038",1332,512,0.72234273318872,820
"VT","Canaan","95000039",249,151,0.6225,98
"VT","Castleton","95000040",987,696,0.586452762923351,291
"VT","Cavendish","95000041",392,261,0.600306278713629,131
"VT","Charleston","95000042",256,169,0.602352941176471,87
"VT","Charlotte","95000043",1677,657,0.718508997429306,1020
"VT","Chelsea","95000044",331,279,0.542622950819672,52
"VT","Chester","95000045",971,489,0.665068493150685,482
"VT","Chittenden","95000046",412,288,0.588571428571429,124
"VT","Clarendon","95000047",648,558,0.537313432835821,90
"VT","Colchester","95000048",4615,2548,0.644283121597096,2067
"VT","Concord","95000049",275,222,0.553319919517103,53
"VT","Corinth","95000050",408,240,0.62962962962963,168
"VT","Cornwall","95000051",509,181,0.73768115942029,328
"VT","Coventry","95000052",297,183,0.61875,114
"VT","Craftsbury","95000053",435,151,0.742320819112628,284
"VT","Danby","95000054",374,236,0.613114754098361,138
"VT","Danville","95000055",695,475,0.594017094017094,220
"VT","Derby","95000056",1234,848,0.592699327569645,386
"VT","Dorset","95000057",762,424,0.642495784148398,338
"VT","Dover","95000058",428,296,0.591160220994475,132
"VT","Dummerston","95000059",897,234,0.793103448275862,663
"VT","Duxbury","95000060",505,184,0.732946298984035,321
"VT","East Haven","95000061",68,51,0.571428571428571,17
"VT","East Montpelier","95000062",1151,402,0.741146168705731,749
"VT","Eden","95000063",320,146,0.686695278969957,174
"VT","Elmore","95000064",359,130,0.734151329243354,229
"VT","Enosburgh","95000065",797,398,0.666945606694561,399
"VT","Essex","95000066",6630,3640,0.645569620253165,2990
"VT","Fair Haven","95000069",678,399,0.629526462395543,279
"VT","Fairfax","95000067",1275,826,0.606853879105188,449
"VT","Fairfield","95000068",552,306,0.643356643356643,246
"VT","Fairlee","95000070",361,153,0.702334630350194,208
"VT","Fayston","95000071",528,189,0.736401673640167,339
"VT","Ferrisburg","95000072",987,514,0.657561625582945,473
"VT","Fletcher","95000073",418,185,0.693200663349917,233
"VT","Franklin","95000074",294,261,0.52972972972973,33
"VT","Georgia","95000075",1228,918,0.572227399813607,310
"VT","Glover","95000076",398,158,0.715827338129496,240
"VT","Goshen","95000077",83,35,0.703389830508475,48
"VT","Grafton","95000078",235,113,0.675287356321839,122
"VT","Granby","95000079",28,15,0.651162790697674,13
"VT","Grand Isle","95000080",729,448,0.619371282922685,281
"VT","Granville","95000081",115,21,0.845588235294118,94
"VT","Greensboro","95000082",299,101,0.7475,198
"VT","Groton","95000083",219,211,0.509302325581395,8
"VT","Guildhall","95000084",75,65,0.535714285714286,10
"VT","Guilford","95000085",853,261,0.765709156193896,592
"VT","Halifax","95000086",260,136,0.656565656565657,124
"VT","Hancock","95000087",99,47,0.678082191780822,52
"VT","Hardwick","95000088",924,384,0.706422018348624,540
"VT","Hartford","95000089",3315,1405,0.702330508474576,1910
"VT","Hartland","95000090",1290,525,0.710743801652893,765
"VT","Highgate","95000091",736,542,0.575899843505477,194
"VT","Hinesburg","95000092",1745,652,0.72799332498957,1093
"VT","Holland","95000093",171,121,0.585616438356164,50
"VT","Hubbardton","95000094",211,141,0.599431818181818,70
"VT","Huntington","95000095",850,232,0.785582255083179,618
"VT","Hyde Park","95000096",1003,387,0.72158273381295,616
"VT","Ira","95000097",132,96,0.578947368421053,36
"VT","Irasburg","95000098",290,234,0.553435114503817,56
"VT","Isle La Motte","95000099",175,113,0.607638888888889,62
"VT","Jamaica","95000100",375,119,0.759109311740891,256
"VT","Jay","95000101",123,69,0.640625,54
"VT","Jericho","95000102",1990,1026,0.659814323607427,964
"VT","Johnson","95000103",919,333,0.734025559105431,586
"VT","Killington","95000182",363,255,0.587378640776699,108
"VT","Kirby","95000104",158,78,0.669491525423729,80
"VT","Landgrove","95000105",82,20,0.803921568627451,62
"VT","Leicester","95000106",292,176,0.623931623931624,116
"VT","Lemington","95000107",28,23,0.549019607843137,5
"VT","Lincoln","95000108",581,181,0.76246719160105,400
"VT","Londonderry","95000109",552,334,0.623024830699774,218
"VT","Lowell","95000110",228,143,0.61455525606469,85
"VT","Ludlow","95000111",652,437,0.598714416896235,215
"VT","Lunenburg","95000112",296,243,0.549165120593692,53
"VT","Lyndon","95000113",1140,866,0.568295114656032,274
"VT","Maidstone","95000114",50,52,0.490196078431373,-2
"VT","Manchester","95000115",1440,850,0.62882096069869,590
"VT","Marlboro","95000116",481,73,0.868231046931408,408
"VT","Marshfield","95000117",521,253,0.67312661498708,268
"VT","Mendon","95000118",319,262,0.549053356282272,57
"VT","Middlebury","95000119",2635,661,0.799453883495146,1974
"VT","Middlesex","95000120",756,216,0.777777777777778,540
"VT","Middletown Springs","95000121",272,163,0.625287356321839,109
"VT","Milton","95000122",2586,1966,0.568101933216169,620
"VT","Monkton","95000123",724,330,0.686907020872865,394
"VT","Montgomery","95000124",410,174,0.702054794520548,236
"VT","Montpelier","95000125",3692,700,0.840619307832423,2992
"VT","Moretown","95000126",664,261,0.717837837837838,403
"VT","Morgan","95000127",162,175,0.480712166172107,-13
"VT","Morristown","95000128",1780,668,0.727124183006536,1112
"VT","Mount Holly","95000129",439,294,0.598908594815825,145
"VT","Mount Tabor","95000130",50,32,0.609756097560976,18
"VT","New Haven","95000134",650,322,0.668724279835391,328
"VT","Newark","95000131",168,111,0.602150537634409,57
"VT","Newbury","95000132",623,375,0.624248496993988,248
"VT","Newfane","95000133",732,200,0.785407725321888,532
"VT","Newport","95000135",961,555,0.633905013192612,406
"VT","Newport Town","95000136",405,270,0.6,135
"VT","North Hero","95000138",312,249,0.556149732620321,63
"VT","Northfield","95000137",1378,685,0.667959282598158,693
"VT","Norton","95000139",45,44,0.50561797752809,1
"VT","Norwich","95000140",1839,293,0.862570356472795,1546
"VT","Orange","95000141",251,248,0.503006012024048,3
"VT","Orwell","95000142",333,275,0.547697368421053,58
"VT","Panton","95000143",208,122,0.63030303030303,86
"VT","Pawlet","95000144",461,254,0.644755244755245,207
"VT","Peacham","95000145",346,136,0.717842323651452,210
"VT","Peru","95000146",160,55,0.744186046511628,105
"VT","Pittsfield","95000147",160,116,0.579710144927536,44
"VT","Pittsford","95000148",891,544,0.620905923344948,347
"VT","Plainfield","95000149",509,118,0.811802232854864,391
"VT","Plymouth","95000150",192,138,0.581818181818182,54
"VT","Pomfret","95000151",431,161,0.728040540540541,270
"VT","Poultney","95000152",857,468,0.646792452830189,389
"VT","Pownal","95000153",1047,507,0.673745173745174,540
"VT","Proctor","95000154",498,294,0.628787878787879,204
"VT","Putney","95000155",1064,188,0.849840255591054,876
"VT","Randolph","95000156",1409,663,0.680019305019305,746
"VT","Reading","95000157",259,102,0.717451523545706,157
"VT","Readsboro","95000158",225,122,0.648414985590778,103
"VT","Richford","95000159",497,257,0.659151193633952,240
"VT","Richmond","95000160",1722,650,0.725969645868465,1072
"VT","Ripton","95000161",267,58,0.821538461538462,209
"VT","Rochester","95000162",463,173,0.727987421383648,290
"VT","Rockingham","95000163",1562,497,0.758620689655172,1065
"VT","Roxbury","95000164",228,91,0.714733542319749,137
"VT","Royalton","95000165",870,355,0.710204081632653,515
"VT","Rupert","95000166",238,137,0.634666666666667,101
"VT","Rutland","95000167",4251,2428,0.63647252582722,1823
"VT","Rutland Town","95000168",1211,1029,0.540625,182
"VT","Ryegate","95000169",342,201,0.629834254143646,141
"VT","Salisbury","95000174",356,171,0.675521821631879,185
"VT","Sandgate","95000175",121,82,0.596059113300493,39
"VT","Searsburg","95000176",24,21,0.533333333333333,3
"VT","Shaftsbury","95000177",1163,673,0.633442265795207,490
"VT","Sharon","95000178",496,202,0.710601719197708,294
"VT","Sheffield","95000179",182,93,0.661818181818182,89
"VT","Shelburne","95000180",3076,1403,0.686760437597678,1673
"VT","Sheldon","95000181",476,283,0.627140974967062,193
"VT","Shoreham","95000183",404,201,0.667768595041322,203
"VT","Shrewsbury","95000184",383,248,0.606973058637084,135
"VT","South Burlington","95000185",6512,2748,0.703239740820734,3764
"VT","South Hero","95000186",724,347,0.676003734827264,377
"VT","Springfield","95000187",2331,1339,0.635149863760218,992
"VT","St. Albans","95000170",1593,752,0.679317697228145,841
"VT","St. Albans Town","95000171",1592,1147,0.58123402701716,445
"VT","St. George","95000172",219,103,0.680124223602484,116
"VT","St. Johnsbury","95000173",1789,1081,0.623344947735192,708
"VT","Stamford","95000188",274,176,0.608888888888889,98
"VT","Stannard","95000189",68,19,0.781609195402299,49
"VT","Starksboro","95000190",582,230,0.716748768472906,352
"VT","Stockbridge","95000191",260,119,0.686015831134565,141
"VT","Stowe","95000192",1805,800,0.692898272552783,1005
"VT","Strafford","95000193",561,114,0.831111111111111,447
"VT","Stratton","95000194",73,70,0.510489510489511,3
"VT","Sudbury","95000195",199,102,0.661129568106312,97
"VT","Sunderland","95000196",310,165,0.652631578947368,145
"VT","Sutton","95000197",254,167,0.60332541567696,87
"VT","Swanton","95000198",1461,947,0.606727574750831,514
"VT","Thetford","95000199",1196,312,0.793103448275862,884
"VT","Tinmouth","95000200",177,109,0.618881118881119,68
"VT","Topsham","95000201",288,208,0.580645161290323,80
"VT","Townshend","95000202",449,191,0.7015625,258
"VT","Troy","95000203",393,236,0.624801271860095,157
"VT","Tunbridge","95000204",500,239,0.6765899864682,261
"VT","Underhill","95000205",1226,565,0.684533780011167,661
"VT","Vergennes","95000206",788,312,0.716363636363636,476
"VT","Vernon","95000207",562,495,0.531693472090823,67
"VT","Vershire","95000208",230,103,0.690690690690691,127
"VT","Victory","95000209",30,18,0.625,12
"VT","Waitsfield","95000210",824,237,0.776625824693685,587
"VT","Walden","95000211",303,158,0.657266811279826,145
"VT","Wallingford","95000212",663,426,0.608815426997245,237
"VT","Waltham","95000213",179,76,0.701960784313725,103
"VT","Wardsboro","95000214",246,130,0.654255319148936,116
"VT","Warren","95000215",774,197,0.797116374871267,577
"VT","Washington","95000216",315,195,0.617647058823529,120
"VT","Waterbury","95000217",1978,654,0.751519756838906,1324
"VT","Waterford","95000218",370,326,0.531609195402299,44
"VT","Waterville","95000219",233,98,0.70392749244713,135
"VT","Weathersfield","95000220",895,509,0.637464387464387,386
"VT","Wells","95000221",270,234,0.535714285714286,36
"VT","West Fairlee","95000222",195,93,0.677083333333333,102
"VT","West Haven","95000225",79,44,0.642276422764228,35
"VT","West Rutland","95000229",597,391,0.604251012145749,206
"VT","West Windsor","95000230",454,219,0.674591381872214,235
"VT","Westfield","95000223",170,112,0.602836879432624,58
"VT","Westford","95000224",742,376,0.663685152057245,366
"VT","Westminster","95000226",1213,338,0.78207607994842,875
"VT","Westmore","95000227",104,92,0.530612244897959,12
"VT","Weston","95000228",282,130,0.684466019417476,152
"VT","Weybridge","95000231",401,127,0.759469696969697,274
"VT","Wheelock","95000232",197,132,0.598784194528875,65
"VT","Whiting","95000233",133,54,0.711229946524064,79
"VT","Whitingham","95000234",376,226,0.624584717607973,150
"VT","Williamstown","95000235",839,549,0.604466858789625,290
"VT","Williston","95000236",3329,1697,0.662355750099483,1632
"VT","Wilmington","95000237",692,327,0.67909715407262,365
"VT","Windham","95000238",146,70,0.675925925925926,76
"VT","Windsor","95000239",1119,406,0.733770491803279,713
"VT","Winhall","95000240",297,189,0.611111111111111,108
"VT","Winooski","95000241",1941,552,0.778580024067389,1389
"VT","Wolcott","95000242",538,221,0.708827404479578,317
"VT","Woodbury","95000243",317,157,0.668776371308017,160
"VT","Woodford","95000244",122,45,0.730538922155689,77
"VT","Woodstock","95000245",1361,508,0.728196896736223,853
"VT","Worcester","95000246",416,111,0.789373814041746,305
"WA","Adams","53001",1516,3111,0.327642100713205,-1595
"WA","Asotin","53003",3993,5647,0.414211618257261,-1654
"WA","Benton","53005",27846,49105,0.361866642408806,-21259
"WA","Chelan","53007",12938,18237,0.415012028869286,-5299
"WA","Clallam","53009",18383,18273,0.501500436490615,110
"WA","Clark","53011",89817,89696,0.500337022945413,121
"WA","Columbia","53013",634,1545,0.290959155575952,-911
"WA","Cowlitz","53015",22507,20538,0.522871413636892,1969
"WA","Douglas","53017",5047,9287,0.352099902330124,-4240
"WA","Ferry","53019",1276,1966,0.393584207279457,-690
"WA","Franklin","53021",7332,11912,0.381001870712949,-4580
"WA","Garfield","53023",335,912,0.268644747393745,-577
"WA","Grant","53025",8834,17677,0.333220172758478,-8843
"WA","Grays Harbor","53027",15692,11743,0.571970111171861,3949
"WA","Island","53029",21080,19251,0.522674865488086,1829
"WA","Jefferson","53031",11985,6113,0.662227870482926,5872
"WA","King","53033",605247,254293,0.704152220955395,350954
"WA","Kitsap","53035",61187,48454,0.55806678158718,12733
"WA","Kittitas","53037",6462,8372,0.435620870972091,-1910
"WA","Klickitat","53039",4373,5138,0.459783408684681,-765
"WA","Lewis","53041",9772,15954,0.379849179818083,-6182
"WA","Lincoln","53043",1649,4024,0.290675127798343,-2375
"WA","Mason","53045",14568,12637,0.535489799669178,1931
"WA","Okanogan","53047",5259,7151,0.423771152296535,-1892
"WA","Pacific","53049",5684,4484,0.559008654602675,1200
"WA","Pend Oreille","53051",2501,3942,0.388173211237001,-1441
"WA","Pierce","53053",184694,147422,0.556112924399908,37272
"WA","San Juan","53055",6943,3061,0.694022391043583,3882
"WA","Skagit","53057",24860,21930,0.531310108997649,2930
"WA","Skamania","53059",2554,2624,0.493240633449208,-70
"WA","Snohomish","53061",173695,123948,0.583568234428493,49747
"WA","Spokane","53063",96781,109754,0.468593700825526,-12973
"WA","Stevens","53065",6521,11655,0.358769806338028,-5134
"WA","Thurston","53067",64879,43703,0.597511558085134,21176
"WA","Wahkiakum","53069",1091,1115,0.49456029011786,-24
"WA","Walla Walla","53071",7083,11057,0.390463065049614,-3974
"WA","Whatcom","53073",49743,38764,0.562023342786446,10979
"WA","Whitman","53075",6910,7460,0.480862908837857,-550
"WA","Yakima","53077",28761,38414,0.42815035355415,-9653
"WI","Adams","55001",5537,4643,0.543909626719057,894
"WI","Ashland","55003",5387,2816,0.656710959405096,2571
"WI","Barron","55005",10883,11413,0.488114459992824,-530
"WI","Bayfield","55007",6025,3597,0.626169195593432,2428
"WI","Brown","55009",62433,64738,0.490937399249829,-2305
"WI","Buffalo","55011",3569,3352,0.515676925299812,217
"WI","Burnett","55013",3981,4541,0.467143862942971,-560
"WI","Calumet","55015",11477,14519,0.441490998615172,-3042
"WI","Chippewa","55017",15211,15371,0.497384082139821,-160
"WI","Clark","55019",6173,7394,0.45500110562394,-1221
"WI","Columbia","55021",17158,13014,0.568672941800345,4144
"WI","Crawford","55023",4622,3064,0.601353109549831,1558
"WI","Dane","55025",215389,83459,0.720730940143484,131930
"WI","Dodge","55027",18745,25190,0.426653010128599,-6445
"WI","Door","55029",9338,8109,0.535220954891959,1229
"WI","Douglas","55031",14855,7698,0.658670686826586,7157
"WI","Dunn","55033",11303,10210,0.525403244549807,1093
"WI","Eau Claire","55035",30618,23218,0.568727245709191,7400
"WI","Florence","55037",952,1643,0.366859344894027,-691
"WI","Fond du Lac","55039",22356,30329,0.424333301698776,-7973
"WI","Forest","55041",2421,2172,0.527106466361855,249
"WI","Grant","55043",13574,10255,0.569642032817156,3319
"WI","Green","55045",11196,7848,0.587901701323251,3348
"WI","Green Lake","55047",3790,5779,0.396070644790469,-1989
"WI","Iowa","55049",8099,4302,0.653092492540924,3797
"WI","Iron","55051",1783,1788,0.499299915989919,-5
"WI","Jackson","55053",5297,3900,0.575948678917038,1397
"WI","Jefferson","55055",20136,23489,0.461570200573066,-3353
"WI","Juneau","55057",6237,5400,0.535962877030162,837
"WI","Kenosha","55059",44838,34942,0.562020556530459,9896
"WI","Kewaunee","55061",5151,5746,0.472698907956318,-595
"WI","La Crosse","55063",36632,25711,0.587588021109026,10921
"WI","Lafayette","55065",4534,3313,0.577800433286606,1221
"WI","Langlade","55067",4569,5810,0.44021582040659,-1241
"WI","Lincoln","55069",7543,7444,0.503302862480817,99
"WI","Manitowoc","55071",20382,21581,0.485713604842361,-1199
"WI","Marathon","55073",32330,36568,0.469244390258063,-4238
"WI","Marinette","55075",9868,10609,0.48190652927675,-741
"WI","Marquette","55077",4112,3758,0.522490470139771,354
"WI","Menominee","55078",1191,179,0.869343065693431,1012
"WI","Milwaukee","55079",328090,158430,0.674360766258324,169660
"WI","Monroe","55081",9505,9637,0.496552084421691,-132
"WI","Oconto","55083",8810,10691,0.451771704015179,-1881
"WI","Oneida","55085",10439,10905,0.489083583208396,-466
"WI","Outagamie","55087",45565,47294,0.490690186196276,-1729
"WI","Ozaukee","55089",19075,35991,0.346402498819598,-16916
"WI","Pepin","55091",1875,1793,0.511177753544166,82
"WI","Pierce","55093",10213,10383,0.49587298504564,-170
"WI","Polk","55095",10054,12075,0.454335939265218,-2021
"WI","Portage","55097",22052,16599,0.570541512509379,5453
"WI","Price","55099",3882,3879,0.500193274062621,3
"WI","Racine","55101",52887,49173,0.51819517930629,3714
"WI","Richland","55103",4964,3575,0.581332708748097,1389
"WI","Rock","55105",49158,30492,0.617175141242938,18666
"WI","Rusk","55107",3391,3673,0.480039637599094,-282
"WI","Sauk","55111",18718,12829,0.593336925856658,5889
"WI","Sawyer","55113",4482,4436,0.502579053599462,46
"WI","Shawano","55115",8990,11017,0.449342730044484,-2027
"WI","Sheboygan","55117",28356,34282,0.452696446246687,-5926
"WI","St. Croix","55109",19874,25475,0.438245606297824,-5601
"WI","Taylor","55119",3761,5597,0.401902115836717,-1836
"WI","Trempealeau","55121",7601,5703,0.571331930246542,1898
"WI","Vernon","55123",8031,5935,0.575039381354719,2096
"WI","Vilas","55125",5931,7735,0.433996780330748,-1804
"WI","Walworth","55127",22512,28962,0.437347010141042,-6450
"WI","Washburn","55129",4435,4692,0.485920894050619,-257
"WI","Washington","55131",23136,54709,0.297205986254737,-31573
"WI","Waukesha","55133",77617,161567,0.324507492139942,-83950
"WI","Waupaca","55135",11565,13989,0.452571026062456,-2424
"WI","Waushara","55137",5330,6558,0.448351278600269,-1228
"WI","Winnebago","55139",45410,42073,0.519072276899512,3337
"WI","Wood","55141",18546,19685,0.485103711647616,-1139
"WV","Barbour","54001",1761,3804,0.31644204851752,-2043
"WV","Berkeley","54003",14122,21956,0.39142968013748,-7834
"WV","Boone","54005",2777,5414,0.339030643389086,-2637
"WV","Braxton","54007",1985,2692,0.424417361556553,-707
"WV","Brooke","54009",3984,5014,0.442765058901978,-1030
"WV","Cabell","54011",13380,17779,0.429410443210629,-4399
"WV","Calhoun","54013",801,1288,0.38343705122068,-487
"WV","Clay","54015",922,1957,0.320250086835707,-1035
"WV","Doddridge","54017",571,2108,0.213139231056364,-1537
"WV","Fayette","54019",5368,8304,0.392627267407841,-2936
"WV","Gilmer","54021",830,1580,0.344398340248963,-750
"WV","Grant","54023",713,3775,0.158868092691622,-3062
"WV","Greenbrier","54025",4681,7873,0.372869205034252,-3192
"WV","Hampshire","54027",2294,5514,0.293801229508197,-3220
"WV","Hancock","54029",4571,7159,0.389684569479966,-2588
"WV","Hardy","54031",1477,3523,0.2954,-2046
"WV","Harrison","54033",9660,15755,0.380090497737557,-6095
"WV","Jackson","54035",3824,7360,0.341917024320458,-3536
"WV","Jefferson","54037",10215,11090,0.479464914339357,-875
"WV","Kanawha","54039",32190,41037,0.439591953787537,-8847
"WV","Lewis","54041",1719,4349,0.283289386947924,-2630
"WV","Lincoln","54043",2204,4336,0.337003058103976,-2132
"WV","Logan","54045",3461,8186,0.297158066454881,-4725
"WV","Marion","54049",8905,11981,0.426362156468448,-3076
"WV","Marshall","54051",3395,6208,0.353535353535354,-2813
"WV","Mason","54053",3738,5706,0.395806861499365,-1968
"WV","McDowell","54047",2086,3931,0.346684394216387,-1845
"WV","Mercer","54055",5416,15406,0.260109499567765,-9990
"WV","Mineral","54057",2836,7687,0.269504894041623,-4851
"WV","Mingo","54059",2421,6163,0.282036346691519,-3742
"WV","Monongalia","54061",13664,16672,0.45042194092827,-3008
"WV","Monroe","54063",1441,3571,0.287509976057462,-2130
"WV","Morgan","54065",2361,4508,0.343718154025331,-2147
"WV","Nicholas","54067",2635,5823,0.311539371009695,-3188
"WV","Ohio","54069",6623,10577,0.385058139534884,-3954
"WV","Pendleton","54071",1067,2087,0.338300570703868,-1020
"WV","Pleasants","54073",942,1805,0.342919548598471,-863
"WV","Pocahontas","54075",1298,2167,0.374603174603175,-869
"WV","Preston","54077",2916,7841,0.271079297201822,-4925
"WV","Putnam","54079",7198,15926,0.311278325549213,-8728
"WV","Raleigh","54081",7651,20375,0.272996503246985,-12724
"WV","Randolph","54083",3325,6150,0.350923482849604,-2825
"WV","Ritchie","54085",762,2889,0.208709942481512,-2127
"WV","Roane","54087",1928,2973,0.393389104264436,-1045
"WV","Summers","54089",1612,2968,0.351965065502183,-1356
"WV","Taylor","54091",1933,3827,0.335590277777778,-1894
"WV","Tucker","54093",876,2160,0.288537549407115,-1284
"WV","Tyler","54095",880,2291,0.277514979501734,-1411
"WV","Upshur","54097",2143,5878,0.267173669118564,-3735
"WV","Wayne","54099",4915,8673,0.361716220194289,-3758
"WV","Webster","54101",939,1708,0.354741216471477,-769
"WV","Wetzel","54103",2194,3449,0.388800283537126,-1255
"WV","Wirt","54105",673,1422,0.321241050119332,-749
"WV","Wood","54107",11067,21980,0.334886676551578,-10913
"WV","Wyoming","54109",1575,5751,0.214987714987715,-4176
"WY","Albany","56001",7445,7851,0.486728556485356,-406
"WY","Big Horn","56003",868,4269,0.168970216079424,-3401
"WY","Campbell","56005",2163,14952,0.12638036809816,-12789
"WY","Carbon","56007",2109,4152,0.336847149017729,-2043
"WY","Converse","56009",1089,5043,0.177592954990215,-3954
"WY","Crook","56011",426,3109,0.120509193776521,-2683
"WY","Fremont","56013",5333,11072,0.325083815909784,-5739
"WY","Goshen","56015",1458,4178,0.258694109297374,-2720
"WY","Hot Springs","56017",523,1894,0.216383947041787,-1371
"WY","Johnson","56019",749,3362,0.182194113354415,-2613
"WY","Laramie","56021",13807,23247,0.372618340799914,-9440
"WY","Lincoln","56023",1287,7144,0.152650931087653,-5857
"WY","Natrona","56025",8960,22129,0.28820483129081,-13169
"WY","Niobrara","56027",200,1022,0.16366612111293,-822
"WY","Park","56029",2927,11234,0.206694442482875,-8307
"WY","Platte","56031",1223,3136,0.280568937829777,-1913
"WY","Sheridan","56033",3618,10267,0.260568959308606,-6649
"WY","Sublette","56035",767,3472,0.180938900684124,-2705
"WY","Sweetwater","56037",4773,11427,0.29462962962963,-6654
"WY","Teton","56039",6211,4858,0.561116632035414,1353
"WY","Uinta","56041",1628,6613,0.197548841160053,-4985
"WY","Washakie","56043",794,3013,0.20856317310218,-2219
"WY","Weston","56045",422,2821,0.130126426148628,-2399
