"state","countyfips","cty","Clinton","Trump","pctClinton","diff2016"
"AK","02000","Alaska",93007,130415,0.416283982776987,-37408
"AL","01001","Autauga",5908,18110,0.245982180031643,-12202
"AL","01003","Baldwin",18409,72780,0.201877419425589,-54371
"AL","01005","Barbour",4848,5431,0.471641210234459,-583
"AL","01007","Bibb",1874,6733,0.217729754850703,-4859
"AL","01009","Blount",2150,22808,0.0861447231348666,-20658
"AL","01011","Bullock",3530,1139,0.756050546155494,2391
"AL","01013","Butler",3716,4891,0.431741605669804,-1175
"AL","01015","Calhoun",13197,32803,0.286891304347826,-19606
"AL","01017","Chambers",5763,7803,0.424812030075188,-2040
"AL","01019","Cherokee",1524,8809,0.147488628665441,-7285
"AL","01021","Chilton",2909,15068,0.161817878400178,-12159
"AL","01023","Choctaw",3109,4102,0.431146858965469,-993
"AL","01025","Clarke",5712,7109,0.44551907027533,-1397
"AL","01027","Clay",1234,5230,0.190903465346535,-3996
"AL","01029","Cleburne",684,5738,0.106508875739645,-5054
"AL","01031","Coffee",4194,15825,0.209500974074629,-11631
"AL","01033","Colbert",7296,16718,0.303822770050804,-9422
"AL","01035","Conecuh",3069,3413,0.473464979944462,-344
"AL","01037","Coosa",1780,3376,0.345228859581071,-1596
"AL","01039","Covington",2379,13222,0.152490224985578,-10843
"AL","01041","Crenshaw",1663,4511,0.269355361192096,-2848
"AL","01043","Cullman",3730,32734,0.10229267222466,-29004
"AL","01045","Dale",4408,13798,0.2421179830825,-9390
"AL","01047","Dallas",12826,5784,0.689199355185384,7042
"AL","01049","DeKalb",3682,21779,0.144613330191273,-18097
"AL","01051","Elmore",8436,27619,0.233975870198308,-19183
"AL","01053","Escambia",4698,10282,0.313618157543391,-5584
"AL","01055","Etowah",10350,32132,0.243632597335342,-21782
"AL","01057","Fayette",1358,6705,0.168423663648766,-5347
"AL","01059","Franklin",2197,9466,0.188373488810769,-7269
"AL","01061","Geneva",1522,9967,0.132474540865175,-8445
"AL","01063","Greene",4006,838,0.827002477291495,3168
"AL","01065","Hale",4772,3172,0.600704934541793,1600
"AL","01067","Henry",2286,5623,0.289037805032242,-3337
"AL","01069","Houston",10547,30567,0.256530622172496,-20020
"AL","01071","Jackson",3663,16643,0.180390032502709,-12980
"AL","01073","Jefferson",151581,130614,0.537149843193536,20967
"AL","01075","Lamar",1035,5819,0.151006711409396,-4784
"AL","01077","Lauderdale",9877,27735,0.262602360948633,-17858
"AL","01079","Lawrence",3611,10732,0.251760440633061,-7121
"AL","01081","Lee",20987,34321,0.379456859767122,-13334
"AL","01083","Limestone",9340,28824,0.244733256472068,-19484
"AL","01085","Lowndes",4882,1751,0.736016885270617,3131
"AL","01087","Macon",7237,1394,0.83848916695632,5843
"AL","01089","Madison",62435,89199,0.411748024849308,-26764
"AL","01091","Marengo",5607,5224,0.51768073123442,383
"AL","01093","Marion",1432,11273,0.112711530893349,-9841
"AL","01095","Marshall",4913,29217,0.14394960445356,-24304
"AL","01097","Mobile",68429,91087,0.428978911206399,-22658
"AL","01099","Monroe",4310,5771,0.427536950699335,-1461
"AL","01101","Montgomery",58669,33928,0.633595040876054,24741
"AL","01103","Morgan",11216,37392,0.230743910467413,-26176
"AL","01105","Perry",3823,1403,0.731534634519709,2420
"AL","01107","Pickens",3972,5454,0.421387651177594,-1482
"AL","01109","Pike",5039,7681,0.396147798742138,-2642
"AL","01111","Randolph",2290,7697,0.229298087513768,-5407
"AL","01113","Russell",9577,9210,0.509767392345771,367
"AL","01115","St. Clair",5550,31579,0.149478844030273,-26029
"AL","01117","Shelby",22927,72846,0.239388971839663,-49919
"AL","01119","Sumter",4739,1581,0.749841772151899,3158
"AL","01121","Talladega",12108,20596,0.370229941291585,-8488
"AL","01123","Tallapoosa",5271,12967,0.289011953065029,-7696
"AL","01125","Tuscaloosa",31746,47701,0.399587146147746,-15955
"AL","01127","Walker",4486,24208,0.156339304384192,-19722
"AL","01129","Washington",2366,6031,0.281767297844468,-3665
"AL","01131","Wilcox",4329,1737,0.713649851632048,2592
"AL","01133","Winston",871,9225,0.0862717908082409,-8354
"AR","05001","Arkansas",1939,3825,0.336398334489938,-1886
"AR","05003","Ashley",2408,5338,0.310870126516912,-2930
"AR","05005","Baxter",4163,14655,0.221224359655649,-10492
"AR","05007","Benton",27894,60751,0.314670878222122,-32857
"AR","05009","Boone",2925,12225,0.193069306930693,-9300
"AR","05011","Bradley",1317,2163,0.378448275862069,-846
"AR","05013","Calhoun",636,1554,0.29041095890411,-918
"AR","05015","Carroll",3334,6773,0.329870386860592,-3439
"AR","05017","Chicot",2350,1716,0.577963600590261,634
"AR","05019","Clark",3606,4398,0.450524737631184,-792
"AR","05021","Clay",1999,3779,0.345967462789893,-1780
"AR","05023","Cleburne",2101,9454,0.181826049329295,-7353
"AR","05025","Cleveland",723,2460,0.227144203581527,-1737
"AR","05027","Columbia",3140,5456,0.365286179618427,-2316
"AR","05029","Conway",2655,4844,0.354047206294173,-2189
"AR","05031","Craighead",10474,22798,0.314799230584275,-12324
"AR","05033","Crawford",4476,16655,0.211821494486773,-12179
"AR","05035","Crittenden",8368,6953,0.546178447881992,1415
"AR","05037","Cross",1995,4577,0.303560559951309,-2582
"AR","05039","Dallas",1165,1507,0.436002994011976,-342
"AR","05041","Desha",2227,1915,0.537662964751328,312
"AR","05043","Drew",2364,3967,0.373400726583478,-1603
"AR","05045","Faulkner",14525,29170,0.332417896784529,-14645
"AR","05047","Franklin",1376,5034,0.214664586583463,-3658
"AR","05049","Fulton",1067,3470,0.235177430019837,-2403
"AR","05051","Garland",12283,26053,0.320403797996661,-13770
"AR","05053","Grant",1407,5160,0.214253083599817,-3753
"AR","05055","Greene",3056,10698,0.222189908390286,-7642
"AR","05057","Hempstead",2371,4391,0.350635906536528,-2020
"AR","05059","Hot Spring",3137,8153,0.277856510186005,-5016
"AR","05061","Howard",1350,3155,0.299667036625971,-1805
"AR","05063","Independence",2878,9925,0.224791064594236,-7047
"AR","05065","Izard",1111,4042,0.215602561614593,-2931
"AR","05067","Jackson",1583,3262,0.326728586171311,-1679
"AR","05069","Jefferson",15721,9231,0.630049695415197,6490
"AR","05071","Johnson",2421,6072,0.285058283292123,-3651
"AR","05073","Lafayette",1028,1750,0.370050395968323,-722
"AR","05075","Lawrence",1263,4064,0.237094049183405,-2801
"AR","05077","Lee",1735,1229,0.585357624831309,506
"AR","05079","Lincoln",1252,2455,0.337739411923388,-1203
"AR","05081","Little River",1397,3604,0.279344131173765,-2207
"AR","05083","Logan",1712,5737,0.229829507316418,-4025
"AR","05085","Lonoke",5638,19902,0.220751761942052,-14264
"AR","05087","Madison",1587,4917,0.2440036900369,-3330
"AR","05089","Marion",1377,5077,0.213356058258444,-3700
"AR","05091","Miller",4273,11293,0.274508544263138,-7020
"AR","05093","Mississippi",5621,6988,0.445792687762709,-1367
"AR","05095","Monroe",1298,1400,0.481097108969607,-102
"AR","05097","Montgomery",735,2573,0.222188633615478,-1838
"AR","05099","Nevada",1156,2001,0.366170414950903,-845
"AR","05101","Newton",699,2875,0.195579182988248,-2176
"AR","05103","Ouachita",4320,5347,0.446881142029585,-1027
"AR","05105","Perry",1035,2979,0.257847533632287,-1944
"AR","05107","Phillips",4292,2443,0.637268002969562,1849
"AR","05109","Pike",684,3150,0.178403755868545,-2466
"AR","05111","Poinsett",1878,3149,0.373582653670181,-1271
"AR","05113","Polk",1210,6606,0.154810644831116,-5396
"AR","05115","Pope",4818,15694,0.234886895475819,-10876
"AR","05117","Prairie",812,2503,0.244947209653092,-1691
"AR","05119","Pulaski",89377,61182,0.593634389176336,28195
"AR","05121","Randolph",1425,4508,0.240182032698466,-3083
"AR","05123","Saint Francis",4031,3195,0.557846664821478,836
"AR","05125","Saline",13247,35852,0.26980182895782,-22605
"AR","05127","Scott",507,2378,0.175736568457539,-1871
"AR","05129","Searcy",601,2955,0.169010123734533,-2354
"AR","05131","Sebastian",12184,28769,0.297511781798647,-16585
"AR","05133","Sevier",1075,3281,0.246786042240588,-2206
"AR","05135","Sharp",1472,5405,0.214046822742475,-3933
"AR","05137","Stone",1189,4081,0.22561669829222,-2892
"AR","05139","Union",5667,10201,0.357133854297958,-4534
"AR","05141","Van Buren",1547,5382,0.223264540337711,-3835
"AR","05143","Washington",32296,40418,0.444151057568006,-8122
"AR","05145","White",5157,21038,0.196869631609086,-15881
"AR","05147","Woodruff",1117,1344,0.45388053636733,-227
"AR","05149","Yell",1472,4600,0.242424242424242,-3128
"AZ","04001","Apache",12196,5315,0.696476500485409,6881
"AZ","04003","Cochise",15291,25036,0.379175242393434,-9745
"AZ","04005","Coconino",25308,16573,0.604283565339892,8735
"AZ","04007","Gila",6746,13672,0.33039474973063,-6926
"AZ","04009","Graham",3301,8025,0.291453293307434,-4724
"AZ","04011","Greenlee",1092,1892,0.365951742627346,-800
"AZ","04012","La Paz",1318,3381,0.280485209619068,-2063
"AZ","04013","Maricopa",549040,590465,0.481823247813744,-41425
"AZ","04015","Mohave",16485,54656,0.231722916461675,-38171
"AZ","04017","Navajo",15362,18165,0.458197870373132,-2803
"AZ","04019","Pima",195649,147019,0.570957895105466,48630
"AZ","04021","Pinal",35737,53857,0.398877156952474,-18120
"AZ","04023","Santa Cruz",10684,3650,0.745360680898563,7034
"AZ","04025","Yavapai",29705,58862,0.335395802048167,-29157
"AZ","04027","Yuma",18336,20586,0.471096038230307,-2250
"CA","06001","Alameda",486351,91189,0.842107905945909,395162
"CA","06003","Alpine",318,211,0.601134215500945,107
"CA","06005","Amador",5904,10239,0.365731276714365,-4335
"CA","06007","Butte",38676,42193,0.478254955545388,-3517
"CA","06009","Calaveras",7738,13072,0.371840461316675,-5334
"CA","06011","Colusa",2659,3551,0.428180354267311,-892
"CA","06013","Contra Costa",286658,105819,0.730381652937624,180839
"CA","06015","Del Norte",3485,5134,0.404339250493097,-1649
"CA","06017","El Dorado",35243,47633,0.425249770741831,-12390
"CA","06019","Fresno",123660,113949,0.520434832013939,9711
"CA","06021","Glenn",3065,5788,0.346210324183892,-2723
"CA","06023","Humboldt",19596,10883,0.642934479477673,8713
"CA","06025","Imperial",28467,11295,0.715934812132186,17172
"CA","06027","Inyo",3155,4248,0.42617857625287,-1093
"CA","06029","Kern",86481,119164,0.420535388655207,-32683
"CA","06031","Kings",12902,17446,0.425135099512324,-4544
"CA","06033","Lake",6240,5752,0.520346897931955,488
"CA","06035","Lassen",2224,7574,0.226985098999796,-5350
"CA","06037","Los Angeles",1893770,620285,0.753273098639449,1273485
"CA","06039","Madera",13283,19221,0.408657396012798,-5938
"CA","06041","Marin",86650,17531,0.831725554563692,69119
"CA","06043","Mariposa",3122,5185,0.375827615264235,-2063
"CA","06045","Mendocino",6905,3571,0.659125620465827,3334
"CA","06047","Merced",21856,18486,0.541767884586783,3370
"CA","06049","Modoc",798,2413,0.248520710059172,-1615
"CA","06051","Mono",2696,2080,0.564489112227806,616
"CA","06053","Monterey",64733,26378,0.710485012786601,38355
"CA","06055","Napa",26161,11946,0.68651428871336,14215
"CA","06057","Nevada",16199,14686,0.524494090982678,1513
"CA","06059","Orange",556544,472669,0.540747153407507,83875
"CA","06061","Placer",61969,78977,0.439664836178395,-17008
"CA","06063","Plumas",3224,5079,0.388293387932073,-1855
"CA","06065","Riverside",339145,309514,0.522840198008507,29631
"CA","06067","Sacramento",273768,163024,0.626769721057162,110744
"CA","06069","San Benito",10050,6471,0.608316687851825,3579
"CA","06071","San Bernardino",312517,253962,0.551683292761073,58555
"CA","06073","San Diego",567243,386807,0.594563178030502,180436
"CA","06075","San Francisco",312443,34493,0.900578204625637,277950
"CA","06077","San Joaquin",89791,68316,0.567912869132929,21475
"CA","06079","San Luis Obispo",63001,52672,0.544647411236849,10329
"CA","06081","San Mateo",219580,53731,0.803407107653918,165849
"CA","06083","Santa Barbara",100120,53740,0.650721435070844,46380
"CA","06085","Santa Clara",483472,137452,0.778633133845688,346020
"CA","06087","Santa Cruz",85185,20158,0.808644143417218,65027
"CA","06089","Shasta",20471,47587,0.300787563548738,-27116
"CA","06091","Sierra",601,1048,0.364463311097635,-447
"CA","06093","Siskiyou",7106,11212,0.387924445900207,-4106
"CA","06095","Solano",97159,49595,0.662053504504136,47564
"CA","06097","Sonoma",116027,37421,0.756132370575048,78606
"CA","06099","Stanislaus",73939,72960,0.503332221458281,979
"CA","06101","Sutter",11831,16780,0.413512285484604,-4949
"CA","06103","Tehama",6571,14981,0.304890497401633,-8410
"CA","06105","Trinity",1876,2409,0.437806301050175,-533
"CA","06107","Tulare",39099,50488,0.436436090057709,-11389
"CA","06109","Tuolumne",8580,13486,0.388833499501496,-4906
"CA","06111","Ventura",170489,118764,0.58941134577688,51725
"CA","06113","Yolo",34460,13178,0.723372097905034,21282
"CA","06115","Yuba",7234,12313,0.370082365580396,-5079
"CO","08001","Adams",86471,73807,0.53950635770349,12664
"CO","08003","Alamosa",3168,3031,0.511050169382158,137
"CO","08005","Arapahoe",148365,109638,0.575051452890083,38727
"CO","08007","Archuleta",2489,4234,0.37022162724974,-1745
"CO","08009","Baca",278,1716,0.139418254764293,-1438
"CO","08011","Bent",581,1166,0.332570120206068,-585
"CO","08013","Boulder",124715,38766,0.762871526354745,85949
"CO","08014","Broomfield",19530,14272,0.577776462931187,5258
"CO","08015","Chaffee",4773,5283,0.47464200477327,-510
"CO","08017","Cheyenne",127,905,0.123062015503876,-778
"CO","08019","Clear Creek",2585,2426,0.515865096787068,159
"CO","08021","Conejos",1753,1885,0.481858163826278,-132
"CO","08023","Costilla",1109,581,0.656213017751479,528
"CO","08025","Crowley",336,1069,0.23914590747331,-733
"CO","08027","Custer",797,2059,0.27906162464986,-1262
"CO","08029","Delta",4048,11584,0.258955987717503,-7536
"CO","08031","Denver",174611,43637,0.800057732487812,130974
"CO","08033","Dolores",227,936,0.19518486672399,-709
"CO","08035","Douglas",67045,100178,0.400931690018718,-33133
"CO","08037","Eagle",12652,8153,0.608123047344388,4499
"CO","08039","Elbert",3056,11536,0.209429824561404,-8480
"CO","08041","El Paso",105807,176506,0.37478614162295,-70699
"CO","08043","Fremont",5275,15066,0.259328449928715,-9791
"CO","08045","Garfield",11205,13071,0.46156697973307,-1866
"CO","08047","Gilpin",1634,1564,0.510944340212633,70
"CO","08049","Grand",3319,4467,0.426277934754688,-1148
"CO","08051","Gunnison",5068,3250,0.609281077182015,1818
"CO","08053","Hinsdale",197,339,0.367537313432836,-142
"CO","08055","Huerfano",1631,1875,0.465202509982886,-244
"CO","08057","Jackson",171,628,0.214017521902378,-457
"CO","08059","Jefferson",151885,130233,0.538374013710575,21652
"CO","08061","Kiowa",91,726,0.111383108935129,-635
"CO","08063","Kit Carson",526,2894,0.153801169590643,-2368
"CO","08065","Lake",1600,1264,0.558659217877095,336
"CO","08067","La Plata",15300,12471,0.550934428000432,2829
"CO","08069","Larimer",92170,82624,0.52730642928247,9546
"CO","08071","Las Animas",2614,3656,0.416905901116427,-1042
"CO","08073","Lincoln",399,1873,0.175616197183099,-1474
"CO","08075","Logan",1843,7272,0.202194185408667,-5429
"CO","08077","Mesa",20958,48129,0.303356637283425,-27171
"CO","08079","Mineral",237,344,0.407917383820998,-107
"CO","08081","Moffat",874,5293,0.141722069077347,-4419
"CO","08083","Montezuma",3920,7771,0.335300658626294,-3851
"CO","08085","Montrose",5438,14303,0.275467301555139,-8865
"CO","08087","Morgan",3128,8104,0.278490028490028,-4976
"CO","08089","Otero",1719,2988,0.365200764818356,-1269
"CO","08091","Ouray",1690,1337,0.558308556326396,353
"CO","08093","Park",3351,6053,0.356337728626117,-2702
"CO","08095","Phillips",436,1791,0.195779074988774,-1355
"CO","08097","Pitkin",7239,2522,0.741624833521156,4717
"CO","08099","Prowers",1173,3508,0.250587481307413,-2335
"CO","08101","Pueblo",27945,27746,0.501786644161534,199
"CO","08103","Rio Blanco",433,2782,0.134681181959565,-2349
"CO","08105","Rio Grande",1985,3060,0.393458870168484,-1075
"CO","08107","Routt",7487,5149,0.592513453624565,2338
"CO","08109","Saguache",1345,1109,0.548084759576202,236
"CO","08111","San Juan",265,215,0.552083333333333,50
"CO","08113","San Miguel",2960,1030,0.741854636591479,1930
"CO","08115","Sedgwick",267,1015,0.208268330733229,-748
"CO","08117","Summit",9502,5064,0.652341068241109,4438
"CO","08119","Teller",3547,9580,0.270206444732231,-6033
"CO","08121","Washington",289,2284,0.112320248736883,-1995
"CO","08123","Weld",45869,75882,0.376744338855533,-30013
"CO","08125","Yuma",701,3755,0.157315978456014,-3054
"CT","09001","Fairfield",238723,155457,0.60561926023644,83266
"CT","09003","Hartford",233789,147912,0.612492500674612,85877
"CT","09005","Litchfield",39836,53376,0.427369866540789,-13540
"CT","09007","Middlesex",45306,38847,0.538376528466008,6459
"CT","09009","New Haven",203601,158373,0.562474100349749,45228
"CT","09011","New London",62951,54574,0.53563922569666,8377
"CT","09013","Tolland",38450,33989,0.530791424508897,4461
"CT","09015","Windham",21776,25738,0.458307025297807,-3962
"DC","11001","Dist. of Columbia",260223,11553,0.957490727658071,248670
"DE","10001","Kent",33347,36989,0.474109986351228,-3642
"DE","10003","New Castle",162905,85507,0.655785549812408,77398
"DE","10005","Sussex",39329,62607,0.385820514832836,-23278
"FL","12001","Alachua",75370,46584,0.618019909146072,28786
"FL","12003","Baker",2112,10294,0.170240206351765,-8182
"FL","12005","Bay",21689,62010,0.25913093346396,-40321
"FL","12007","Bradford",2924,8913,0.247022049505787,-5989
"FL","12009","Brevard",119525,181620,0.396901824702386,-62095
"FL","12011","Broward",546956,258521,0.679046080769532,288435
"FL","12013","Calhoun",1236,4647,0.210096889342172,-3411
"FL","12015","Charlotte",33421,60196,0.356997126590256,-26775
"FL","12017","Citrus",22765,54377,0.29510513079775,-31612
"FL","12019","Clay",27768,74898,0.270469288761615,-47130
"FL","12021","Collier",60941,105297,0.366588866564805,-44356
"FL","12023","Columbia",7599,20359,0.271800557979827,-12760
"FL","12027","DeSoto",3761,6744,0.358019990480723,-2983
"FL","12029","Dixie",1270,5822,0.179075014100395,-4552
"FL","12031","Duval",203627,210061,0.492223608129798,-6434
"FL","12033","Escambia",57114,88370,0.392579252701328,-31256
"FL","12035","Flagler",21985,33804,0.394074100629156,-11819
"FL","12037","Franklin",1738,4119,0.296738944852313,-2381
"FL","12039","Gadsden",14994,6721,0.690490444393277,8273
"FL","12041","Gilchrist",1457,6740,0.177747956569477,-5283
"FL","12043","Glades",1271,2996,0.29786735411296,-1725
"FL","12045","Gulf",1715,5320,0.243781094527363,-3605
"FL","12047","Hamilton",1899,3439,0.355751217684526,-1540
"FL","12049","Hardee",2147,5238,0.290724441435342,-3091
"FL","12051","Hendry",4610,6192,0.426772819848176,-1582
"FL","12053","Hernando",31818,59029,0.350237212015807,-27211
"FL","12055","Highlands",14901,29509,0.33553253771673,-14608
"FL","12057","Hillsborough",306422,265928,0.535375207477942,40494
"FL","12059","Holmes",852,7476,0.102305475504323,-6624
"FL","12061","Indian River",28997,48564,0.373860574257681,-19567
"FL","12063","Jackson",6383,14231,0.309643931308819,-7848
"FL","12065","Jefferson",3537,3930,0.473684210526316,-393
"FL","12067","Lafayette",515,2795,0.155589123867069,-2280
"FL","12069","Lake",62597,101888,0.380563577225887,-39291
"FL","12071","Lee",124725,191141,0.394866810609562,-66416
"FL","12073","Leon",91936,53777,0.630938900441278,38159
"FL","12075","Levy",5091,13758,0.270093904185898,-8667
"FL","12077","Liberty",651,2542,0.203883495145631,-1891
"FL","12079","Madison",3526,4849,0.421014925373134,-1323
"FL","12081","Manatee",71066,101681,0.411387752030426,-30615
"FL","12083","Marion",61958,107710,0.365171982931372,-45752
"FL","12085","Martin",30158,53182,0.361867050635949,-23024
"FL","12086","Miami-Dade",623006,333666,0.651222153465347,289340
"FL","12087","Monroe",18949,21885,0.464049566537689,-2936
"FL","12089","Nassau",10849,34221,0.240714444197914,-23372
"FL","12091","Okaloosa",23711,71788,0.248285322359396,-48077
"FL","12093","Okeechobee",3953,9342,0.29732982324182,-5389
"FL","12095","Orange",329579,195091,0.628164369984943,134488
"FL","12097","Osceola",85287,50252,0.629243243642051,35035
"FL","12099","Palm Beach",371411,270762,0.578365954345636,100649
"FL","12101","Pasco",89998,141943,0.388021091570701,-51945
"FL","12103","Pinellas",233327,238746,0.494260421587339,-5419
"FL","12105","Polk",117182,157216,0.427051217574472,-40034
"FL","12107","Putnam",9920,21873,0.312018368823326,-11953
"FL","12109","St. Johns",43037,88633,0.326855016328701,-45596
"FL","12111","St. Lucie",66812,70248,0.487465343645119,-3436
"FL","12113","Santa Rosa",18398,65126,0.220272017623677,-46728
"FL","12115","Sarasota",97676,124098,0.44043034801194,-26422
"FL","12117","Seminole",105611,109265,0.491497421768834,-3654
"FL","12119","Sumter",22631,52722,0.300333098881266,-30091
"FL","12121","Suwannee",3955,14281,0.216878701469621,-10326
"FL","12123","Taylor",2149,6923,0.236882716049383,-4774
"FL","12125","Union",1014,4567,0.181687869557427,-3553
"FL","12127","Volusia",108793,142763,0.432480242967769,-33970
"FL","12129","Wakulla",4348,10507,0.292696061932009,-6159
"FL","12131","Walton",6861,25695,0.210744563214154,-18834
"FL","12133","Washington",2261,8630,0.207602607657699,-6369
"GA","13001","Appling",1434,5492,0.207045913947444,-4058
"GA","13003","Atkinson",696,1873,0.270922537952511,-1177
"GA","13005","Bacon",607,3356,0.153166792833712,-2749
"GA","13007","Baker",650,775,0.456140350877193,-125
"GA","13009","Baldwin",7965,7691,0.508750638732754,274
"GA","13011","Banks",684,6130,0.100381567361315,-5446
"GA","13013","Barrow",6580,21105,0.237673830594185,-14525
"GA","13015","Bartow",8204,29879,0.215424205025865,-21675
"GA","13017","Ben Hill",2098,3734,0.359739368998628,-1636
"GA","13019","Berrien",1041,5408,0.161420375251977,-4367
"GA","13021","Bibb",34383,22589,0.603506985887804,11794
"GA","13023","Bleckley",1094,3717,0.22739555186032,-2623
"GA","13025","Brantley",619,5561,0.100161812297735,-4942
"GA","13027","Brooks",2504,3679,0.404981400614588,-1175
"GA","13029","Bryan",4010,10513,0.276113750602493,-6503
"GA","13031","Bulloch",8812,14476,0.378392305049811,-5664
"GA","13033","Burke",4730,4491,0.512959548855872,239
"GA","13035","Butts",2566,6717,0.276419261014758,-4151
"GA","13037","Calhoun",1178,829,0.586945690084704,349
"GA","13039","Camden",5914,12287,0.324927201802099,-6373
"GA","13043","Candler",1023,2661,0.277687296416938,-1638
"GA","13045","Carroll",12422,29983,0.292937153637543,-17561
"GA","13047","Catoosa",4769,20860,0.186078270708962,-16091
"GA","13049","Charlton",1004,2950,0.253920080930703,-1946
"GA","13051","Chatham",58998,43649,0.574765945424611,15349
"GA","13053","Chattahoochee",593,746,0.442867811799851,-153
"GA","13055","Chattooga",1612,6457,0.199776924030239,-4845
"GA","13057","Cherokee",25203,80611,0.238182093106772,-55408
"GA","13059","Clarke",29514,12691,0.699301030683568,16823
"GA","13061","Clay",697,566,0.551860649247823,131
"GA","13063","Clayton",75908,11740,0.866055129609346,64168
"GA","13065","Clinch",685,1724,0.284350352843504,-1039
"GA","13067","Cobb",159416,152602,0.510919241838612,6814
"GA","13069","Coffee",4090,9575,0.299304793267472,-5485
"GA","13071","Colquitt",3460,9892,0.259137207908928,-6432
"GA","13073","Columbia",18863,43060,0.304620254186651,-24197
"GA","13075","Cook",1752,4175,0.295596423148304,-2423
"GA","13077","Coweta",16572,42513,0.28047727849708,-25941
"GA","13079","Crawford",1419,3632,0.280934468422095,-2213
"GA","13081","Crisp",2835,4539,0.384458909682669,-1704
"GA","13083","Dade",965,5047,0.160512308715902,-4082
"GA","13085","Dawson",1444,9880,0.12751677852349,-8436
"GA","13087","Decatur",4104,6009,0.405814298427766,-1905
"GA","13089","DeKalb",239131,47531,0.834191486838158,191600
"GA","13091","Dodge",1836,5021,0.267755578241213,-3185
"GA","13093","Dooly",1860,1941,0.489344909234412,-81
"GA","13095","Dougherty",23224,10227,0.694269229619443,12997
"GA","13097","Douglas",30971,24803,0.555294581704737,6168
"GA","13099","Early",2165,2552,0.458978164087344,-387
"GA","13101","Echols",156,1006,0.134251290877797,-850
"GA","13103","Effingham",4851,17865,0.213549920760697,-13014
"GA","13105","Elbert",2507,5269,0.322402263374486,-2762
"GA","13107","Emanuel",2433,5330,0.313409764266392,-2897
"GA","13109","Evans",1130,2404,0.319750990379174,-1274
"GA","13111","Fannin",1920,9622,0.166348986310865,-7702
"GA","13113","Fayette",23255,35034,0.398960352725214,-11779
"GA","13115","Floyd",9127,24045,0.275141685759074,-14918
"GA","13117","Forsyth",23427,69801,0.251287166945553,-46374
"GA","13119","Franklin",1243,7054,0.149813185488731,-5811
"GA","13121","Fulton",281875,110372,0.71861607609491,171503
"GA","13123","Gilmer",1955,10465,0.157407407407407,-8510
"GA","13125","Glascock",138,1235,0.100509832483613,-1097
"GA","13127","Glynn",11738,21482,0.353341360626129,-9744
"GA","13129","Gordon",3176,15171,0.17310731999782,-11995
"GA","13131","Grady",3005,6047,0.331970835174547,-3042
"GA","13133","Greene",3194,5488,0.367887583506105,-2294
"GA","13135","Gwinnett",165063,146463,0.529853045973691,18600
"GA","13137","Habersham",2483,13184,0.158485989659794,-10701
"GA","13139","Hall",16153,51681,0.238125423828758,-35528
"GA","13141","Hancock",2695,841,0.762160633484163,1854
"GA","13143","Haralson",1474,9579,0.133357459513254,-8105
"GA","13145","Harris",4082,11931,0.254917879223131,-7849
"GA","13147","Hart",2583,7285,0.261755168220511,-4702
"GA","13149","Heard",743,3370,0.180646729880866,-2627
"GA","13151","Henry",49902,45641,0.522298860199073,4261
"GA","13153","Houston",22460,35351,0.388507377488713,-12891
"GA","13155","Irwin",890,2711,0.247153568453207,-1821
"GA","13157","Jackson",4469,21754,0.170422911184838,-17285
"GA","13159","Jasper",1544,4353,0.261828048160081,-2809
"GA","13161","Jeff Davis",901,4102,0.1800919448331,-3201
"GA","13163","Jefferson",3809,3057,0.554762598310516,752
"GA","13165","Jenkins",1108,1892,0.369333333333333,-784
"GA","13167","Johnson",1136,2519,0.310807113543092,-1383
"GA","13169","Jones",3960,8304,0.322896281800391,-4344
"GA","13171","Lamar",2267,5183,0.304295302013423,-2916
"GA","13173","Lanier",805,1984,0.288633918967372,-1179
"GA","13175","Laurens",6737,12401,0.352022154875118,-5664
"GA","13177","Lee",3166,10641,0.229303976243934,-7475
"GA","13179","Liberty",9531,6125,0.608776188042923,3406
"GA","13181","Lincoln",1271,2759,0.315384615384615,-1488
"GA","13183","Long",1356,2623,0.340789143000754,-1267
"GA","13185","Lowndes",14614,21308,0.406825900562329,-6694
"GA","13187","Lumpkin",2216,9613,0.187336207625328,-7397
"GA","13189","McDuffie",3699,5432,0.405103493593254,-1733
"GA","13191","McIntosh",2298,3482,0.39757785467128,-1184
"GA","13193","Macon",2705,1540,0.637220259128386,1165
"GA","13195","Madison",2423,9195,0.208555689447409,-6772
"GA","13197","Marion",1213,1921,0.387045309508615,-708
"GA","13199","Meriwether",3800,5216,0.421472937000887,-1416
"GA","13201","Miller",622,1888,0.247808764940239,-1266
"GA","13205","Mitchell",3492,4272,0.449768160741886,-780
"GA","13207","Monroe",3570,8821,0.288112339601324,-5251
"GA","13209","Montgomery",847,2668,0.240967283072546,-1821
"GA","13211","Morgan",2658,6559,0.288380167082565,-3901
"GA","13213","Murray",1799,10340,0.148200016475822,-8541
"GA","13215","Muscogee",39602,26901,0.595491932694766,12701
"GA","13217","Newton",21936,20907,0.512008962957776,1029
"GA","13219","Oconee",5253,12885,0.289612967251075,-7632
"GA","13221","Oglethorpe",1829,4622,0.283521934583785,-2793
"GA","13223","Paulding",18004,44646,0.287374301675978,-26642
"GA","13225","Peach",5083,5405,0.484649122807018,-322
"GA","13227","Pickens",1977,11651,0.145068975638392,-9674
"GA","13229","Pierce",903,6301,0.125347029428096,-5398
"GA","13231","Pike",1239,7273,0.145559210526316,-6034
"GA","13233","Polk",2863,11006,0.206431610065614,-8143
"GA","13235","Pulaski",1104,2436,0.311864406779661,-1332
"GA","13237","Putnam",2745,6516,0.296404275996113,-3771
"GA","13239","Quitman",461,575,0.444980694980695,-114
"GA","13241","Rabun",1443,6287,0.186675291073739,-4844
"GA","13243","Randolph",1597,1270,0.557028252528776,327
"GA","13245","Richmond",48707,24441,0.665869196697107,24266
"GA","13247","Rockdale",23206,13463,0.63285063677766,9743
"GA","13249","Schley",401,1472,0.214095034703684,-1071
"GA","13251","Screven",2300,3305,0.410347903657449,-1005
"GA","13253","Seminole",1186,2343,0.336072541796543,-1157
"GA","13255","Spalding",9347,15636,0.374134411399752,-6289
"GA","13257","Stephens",1835,7682,0.192812861195755,-5847
"GA","13259","Stewart",1220,805,0.602469135802469,415
"GA","13261","Sumter",5520,5275,0.511347846225104,245
"GA","13263","Talbot",2001,1196,0.62589928057554,805
"GA","13265","Taliaferro",545,349,0.609619686800895,196
"GA","13267","Tattnall",1678,5092,0.247858197932053,-3414
"GA","13269","Taylor",1295,2062,0.38576109621686,-767
"GA","13271","Telfair",1313,2449,0.349016480595428,-1136
"GA","13273","Terrell",2267,1872,0.547716839816381,395
"GA","13275","Thomas",7138,11225,0.388716440668736,-4087
"GA","13277","Tift",3892,8680,0.309576837416481,-4788
"GA","13279","Toombs",2338,6612,0.26122905027933,-4274
"GA","13281","Towns",1206,5377,0.183199149324016,-4171
"GA","13283","Treutlen",860,1808,0.322338830584708,-948
"GA","13285","Troup",9597,15643,0.380229793977813,-6046
"GA","13287","Turner",1243,2094,0.372490260713215,-851
"GA","13289","Twiggs",1970,2034,0.492007992007992,-64
"GA","13291","Union",1962,9849,0.166116332232664,-7887
"GA","13293","Upson",3471,7288,0.322613625801654,-3817
"GA","13295","Walker",4213,18938,0.181979180165004,-14725
"GA","13297","Walton",8279,31093,0.21027633851468,-22814
"GA","13299","Ware",3436,8508,0.287675820495646,-5072
"GA","13301","Warren",1313,991,0.569878472222222,322
"GA","13303","Washington",4187,4138,0.502942942942943,49
"GA","13305","Wayne",2039,8147,0.200176713135676,-6108
"GA","13307","Webster",471,630,0.427792915531335,-159
"GA","13309","Wheeler",646,1421,0.312530237058539,-775
"GA","13311","White",1672,9751,0.146371356036068,-8079
"GA","13313","Whitfield",7925,21514,0.269200720133157,-13589
"GA","13315","Wilcox",852,2096,0.289009497964722,-1244
"GA","13317","Wilkes",1844,2569,0.417856333559937,-725
"GA","13319","Wilkinson",1893,2332,0.448047337278107,-439
"GA","13321","Worth",2015,6144,0.246966540017159,-4129
"HI","15001","Hawaii",41258,17500,0.702168215391947,23758
"HI","15003","Honolulu",175634,90296,0.66045199864626,85338
"HI","15007","Kauai",16456,7574,0.684810653349979,8882
"HI","15009","Maui",33479,13445,0.713472849714432,20034
"IA","19001","Adair",1127,2456,0.314540887524421,-1329
"IA","19003","Adams",565,1393,0.28855975485189,-828
"IA","19005","Allamakee",2409,4072,0.371701897855269,-1663
"IA","19007","Appanoose",1813,4031,0.310232717316906,-2218
"IA","19009","Audubon",1079,2135,0.335718730553827,-1056
"IA","19011","Benton",4672,8226,0.362226701814235,-3554
"IA","19013","Black Hawk",32006,27382,0.53893042365461,4624
"IA","19015","Boone",5517,7458,0.425202312138728,-1941
"IA","19017","Bremer",5349,7199,0.426283072999681,-1850
"IA","19019","Buchanan",3966,5504,0.418796198521647,-1538
"IA","19021","Buena Vista",2851,4895,0.368060934675962,-2044
"IA","19023","Butler",2163,4918,0.305465329755684,-2755
"IA","19025","Calhoun",1396,3466,0.287124640065817,-2070
"IA","19027","Carroll",3305,6627,0.332762786951269,-3322
"IA","19029","Cass",1946,4755,0.290404417251157,-2809
"IA","19031","Cedar",3578,5275,0.404156783011409,-1697
"IA","19033","Cerro Gordo",9840,11583,0.459319423049993,-1743
"IA","19035","Cherokee",1676,4188,0.28581173260573,-2512
"IA","19037","Chickasaw",2264,3739,0.377144760952857,-1475
"IA","19039","Clarke",1463,2706,0.350923482849604,-1243
"IA","19041","Clay",2246,5870,0.276737309019221,-3624
"IA","19043","Clayton",3236,5309,0.378700994733762,-2073
"IA","19045","Clinton",10079,11249,0.472571267816954,-1170
"IA","19047","Crawford",1985,4608,0.301076899742151,-2623
"IA","19049","Dallas",15662,19288,0.448125894134478,-3626
"IA","19051","Davis",976,2721,0.263997836083311,-1745
"IA","19053","Decatur",1201,2296,0.343437231913068,-1095
"IA","19055","Delaware",2956,5688,0.341971309578899,-2732
"IA","19057","Des Moines",8178,9479,0.46315908704763,-1301
"IA","19059","Dickinson",3051,6743,0.311517255462528,-3692
"IA","19061","Dubuque",22774,23384,0.493392261363144,-610
"IA","19063","Emmet",1356,3121,0.302881393790485,-1765
"IA","19065","Fayette",3666,5591,0.396024630009722,-1925
"IA","19067","Floyd",3177,4371,0.420906200317965,-1194
"IA","19069","Franklin",1490,3153,0.320913202670687,-1663
"IA","19071","Fremont",959,2401,0.285416666666667,-1442
"IA","19073","Greene",1688,2819,0.374528511204793,-1131
"IA","19075","Grundy",1847,4516,0.29027188433129,-2669
"IA","19077","Guthrie",1720,3603,0.323126056734924,-1883
"IA","19079","Hamilton",2715,4450,0.378925331472435,-1735
"IA","19081","Hancock",1582,3972,0.284839755131437,-2390
"IA","19083","Hardin",2774,5231,0.346533416614616,-2457
"IA","19085","Harrison",2123,4892,0.30263720598717,-2769
"IA","19087","Henry",2897,5764,0.334487934418658,-2867
"IA","19089","Howard",1674,2611,0.390665110851809,-937
"IA","19091","Humboldt",1251,3564,0.25981308411215,-2313
"IA","19093","Ida",792,2655,0.22976501305483,-1863
"IA","19095","Iowa",3070,5193,0.371535761829844,-2123
"IA","19097","Jackson",3837,5821,0.397287223027542,-1984
"IA","19099","Jasper",7108,10556,0.402400362318841,-3448
"IA","19101","Jefferson",3702,3738,0.49758064516129,-36
"IA","19103","Johnson",49942,20993,0.704053006273349,28949
"IA","19105","Jones",3779,5718,0.39791513109403,-1939
"IA","19107","Keokuk",1265,3385,0.272043010752688,-2120
"IA","19109","Kossuth",2529,5637,0.309698750918442,-3108
"IA","19111","Lee",6195,8762,0.414187337032827,-2567
"IA","19113","Linn",58481,48183,0.548273081827046,10298
"IA","19115","Louisa",1643,3060,0.34935147778014,-1417
"IA","19117","Lucas",1236,2873,0.300803115113166,-1637
"IA","19119","Lyon",917,5188,0.15020475020475,-4271
"IA","19121","Madison",2666,5336,0.333166708322919,-2670
"IA","19123","Mahaska",2606,7404,0.26033966033966,-4798
"IA","19125","Marion",5469,10940,0.333292705222744,-5471
"IA","19127","Marshall",7623,9125,0.455158824934321,-1502
"IA","19129","Mills",2080,5050,0.291725105189341,-2970
"IA","19131","Mitchell",1879,3180,0.37141727614153,-1301
"IA","19133","Monona",1244,3115,0.285386556549667,-1871
"IA","19135","Monroe",1053,2635,0.285520607375271,-1582
"IA","19137","Montgomery",1312,3431,0.276618174151381,-2119
"IA","19139","Muscatine",8284,9549,0.464532047327987,-1265
"IA","19141","O'Brien",1314,5735,0.186409419775855,-4421
"IA","19143","Osceola",552,2528,0.179220779220779,-1976
"IA","19145","Page",1801,4875,0.269772318753745,-3074
"IA","19147","Palo Alto",1395,3079,0.311801519892713,-1684
"IA","19149","Plymouth",2878,9659,0.229560500917285,-6781
"IA","19151","Pocahontas",962,2692,0.263273125342091,-1730
"IA","19153","Polk",119671,93421,0.561593114711017,26250
"IA","19155","Pottawattamie",15341,24441,0.385626665326027,-9100
"IA","19157","Poweshiek",4272,4936,0.463944396177237,-664
"IA","19159","Ringgold",753,1820,0.292654488923436,-1067
"IA","19161","Sac",1269,3692,0.255795202580125,-2423
"IA","19163","Scott",40302,39083,0.507677772879007,1219
"IA","19165","Shelby",1649,4340,0.275338119886459,-2691
"IA","19167","Sioux",2289,14761,0.13425219941349,-12472
"IA","19169","Story",25085,19111,0.56758530183727,5974
"IA","19171","Tama",3194,4968,0.391325655476599,-1774
"IA","19173","Taylor",755,2108,0.263709395738736,-1353
"IA","19175","Union",1920,3521,0.35287630950193,-1601
"IA","19177","Van Buren",843,2524,0.25037125037125,-1681
"IA","19179","Wapello",5591,8710,0.39095168170058,-3119
"IA","19181","Warren",10371,14773,0.412464206172447,-4402
"IA","19183","Washington",3938,6170,0.389592402057776,-2232
"IA","19185","Wayne",719,2069,0.257890961262554,-1350
"IA","19187","Webster",6293,10049,0.385081385387345,-3756
"IA","19189","Winnebago",1920,3437,0.358409557588202,-1517
"IA","19191","Winneshiek",5238,5332,0.495553453169347,-94
"IA","19193","Woodbury",16102,24627,0.395344840285791,-8525
"IA","19195","Worth",1523,2443,0.384014120020171,-920
"IA","19197","Wright",1890,3790,0.332746478873239,-1900
"ID","16001","Ada",75676,93748,0.446666351874587,-18072
"ID","16003","Adams",415,1556,0.210553018772197,-1141
"ID","16005","Bannock",10342,17180,0.375772109585059,-6838
"ID","16007","Bear Lake",255,2203,0.103742880390561,-1948
"ID","16009","Benewah",780,3101,0.200979129090441,-2321
"ID","16011","Bingham",2924,10907,0.211409153351168,-7983
"ID","16013","Blaine",6416,3340,0.657646576465765,3076
"ID","16015","Boise",777,2673,0.225217391304348,-1896
"ID","16017","Bonner",5140,10220,0.334635416666667,-5080
"ID","16019","Bonneville",8930,26699,0.250638524797216,-17769
"ID","16021","Boundary",933,3789,0.197585768742058,-2856
"ID","16023","Butte",160,914,0.148975791433892,-754
"ID","16025","Camas",110,410,0.211538461538462,-300
"ID","16027","Canyon",16683,46755,0.26298117847347,-30072
"ID","16029","Caribou",271,2275,0.106441476826394,-2004
"ID","16031","Cassia",1036,5949,0.148317823908375,-4913
"ID","16033","Clark",44,203,0.178137651821862,-159
"ID","16035","Clearwater",704,2852,0.197975253093363,-2148
"ID","16037","Custer",427,1777,0.193738656987296,-1350
"ID","16039","Elmore",1814,5816,0.237745740498034,-4002
"ID","16041","Franklin",385,3901,0.0898273448436771,-3516
"ID","16043","Fremont",651,4091,0.137283846478279,-3440
"ID","16045","Gem",1229,5980,0.170481342765987,-4751
"ID","16047","Gooding",930,3743,0.199015621656324,-2813
"ID","16049","Idaho County",1196,6441,0.156605997119288,-5245
"ID","16051","Jefferson",976,8436,0.103697407564811,-7460
"ID","16053","Jerome",2117,7347,0.223689771766695,-5230
"ID","16055","Kootenai",16264,44449,0.267883319882068,-28185
"ID","16057","Latah",8093,7255,0.527299973937972,838
"ID","16059","Lemhi",733,3011,0.195779914529915,-2278
"ID","16061","Lewis",270,1202,0.183423913043478,-932
"ID","16063","Lincoln",360,1184,0.233160621761658,-824
"ID","16065","Madison",1201,8941,0.118418457897851,-7740
"ID","16067","Minidoka",1167,4887,0.192765113974232,-3720
"ID","16069","Nez Perce",4828,10699,0.310942229664455,-5871
"ID","16071","Oneida",184,1531,0.107288629737609,-1347
"ID","16073","Owyhee",591,3052,0.162228932198737,-2461
"ID","16075","Payette",892,4306,0.171604463255098,-3414
"ID","16077","Power",699,1666,0.295560253699789,-967
"ID","16079","Shoshone",1384,3297,0.295663319803461,-1913
"ID","16081","Teton",2157,2161,0.499536822603057,-4
"ID","16083","Twin Falls",6844,21063,0.245243128964059,-14219
"ID","16085","Valley",1913,2906,0.396970325793733,-993
"ID","16087","Washington",776,3283,0.191180093619118,-2507
"IL","17001","Adams",7633,22732,0.251374938251276,-15099
"IL","17003","Alexander",1262,1496,0.457577955039884,-234
"IL","17005","Bond",2066,4884,0.29726618705036,-2818
"IL","17007","Boone",8952,12261,0.422005374063075,-3309
"IL","17009","Brown",475,1776,0.211017325633052,-1301
"IL","17011","Bureau",6010,9264,0.393479114835668,-3254
"IL","17013","Calhoun",739,1719,0.300650935720098,-980
"IL","17015","Carroll",2437,4428,0.354989075018208,-1991
"IL","17017","Cass",1617,3216,0.334574798261949,-1599
"IL","17019","Champaign",49694,33235,0.599235490600393,16459
"IL","17021","Christian",3982,10522,0.274544953116382,-6540
"IL","17023","Clark",1873,5620,0.249966635526491,-3747
"IL","17025","Clay",1014,5009,0.168354640544579,-3995
"IL","17027","Clinton",3939,12394,0.241168187105859,-8455
"IL","17029","Coles",7285,12985,0.359398125308337,-5700
"IL","17031","Cook",1528582,440213,0.776404856777877,1088369
"IL","17033","Crawford",1969,6146,0.242637091805299,-4177
"IL","17035","Cumberland",1028,4200,0.19663351185922,-3172
"IL","17037","DeKalb",20348,19051,0.516459808624584,1297
"IL","17039","DeWitt",1907,5072,0.273248316377705,-3165
"IL","17041","Douglas",1946,5695,0.254678706975527,-3749
"IL","17043","DuPage",222499,164355,0.575149798115051,58144
"IL","17045","Edgar",1778,5634,0.239881273610362,-3856
"IL","17047","Edwards",432,2777,0.13462137737613,-2345
"IL","17049","Effingham",3071,13613,0.184068568688564,-10542
"IL","17051","Fayette",1814,7363,0.197668083251607,-5549
"IL","17053","Ford",1410,4474,0.23963290278722,-3064
"IL","17055","Franklin",4711,13101,0.264484617112059,-8390
"IL","17057","Fulton",6118,8482,0.419041095890411,-2364
"IL","17059","Gallatin",656,1942,0.252501924557352,-1286
"IL","17061","Greene",1202,4139,0.225051488485302,-2937
"IL","17063","Grundy",8021,13417,0.374148707901857,-5396
"IL","17065","Hamilton",800,3205,0.199750312109863,-2405
"IL","17067","Hancock",1744,5713,0.233874212149658,-3969
"IL","17069","Hardin",419,1650,0.202513291445143,-1231
"IL","17071","Henderson",1151,2153,0.348365617433414,-1002
"IL","17073","Henry",8835,13962,0.387550993551783,-5127
"IL","17075","Iroquois",2496,9728,0.204188481675393,-7232
"IL","17077","Jackson",11619,10889,0.516216456371068,730
"IL","17079","Jasper",924,3973,0.188686951194609,-3049
"IL","17081","Jefferson",4408,11681,0.27397600845298,-7273
"IL","17083","Jersey",2673,7737,0.256772334293948,-5064
"IL","17085","JoDaviess",4452,6113,0.421391386654046,-1661
"IL","17087","Johnson",1135,4644,0.196400761377401,-3509
"IL","17089","Kane",99389,82087,0.54767021534528,17302
"IL","17091","Kankakee",18908,25081,0.429834731410125,-6173
"IL","17093","Kendall",23392,24152,0.492007403668181,-760
"IL","17095","Knox",9939,10658,0.482546001844929,-719
"IL","17097","Lake",168186,108608,0.6076215524903,59578
"IL","17099","LaSalle",19277,26269,0.423242436218329,-6992
"IL","17101","Lawrence",1288,4517,0.221877691645134,-3229
"IL","17103","Lee",5499,8597,0.39011066969353,-3098
"IL","17105","Livingston",4005,10197,0.282002534854246,-6192
"IL","17107","Logan",3301,8167,0.287844436693408,-4866
"IL","17109","McDonough",5278,6789,0.437391232286401,-1511
"IL","17111","McHenry",59827,71117,0.456889968230694,-11290
"IL","17113","McLean",35918,37081,0.492034137453938,-1163
"IL","17115","Macon",18211,26782,0.404751850287823,-8571
"IL","17117","Macoupin",6532,14194,0.315159702788768,-7662
"IL","17119","Madison",50336,70295,0.417272508724955,-19959
"IL","17121","Marion",4231,11677,0.265966809152628,-7446
"IL","17123","Marshall",1784,3776,0.320863309352518,-1992
"IL","17125","Mason",2008,4051,0.331407823073114,-2043
"IL","17127","Massac",1555,4844,0.243006719799969,-3289
"IL","17129","Menard",1808,4230,0.299436899635641,-2422
"IL","17131","Mercer",3061,4800,0.389390662765551,-1739
"IL","17133","Monroe",5522,12614,0.304477282752536,-7092
"IL","17135","Montgomery",3490,8616,0.288286799933917,-5126
"IL","17137","Morgan",4693,9060,0.341234639714971,-4367
"IL","17139","Moultrie",1476,4453,0.24894585933547,-2977
"IL","17141","Ogle",8025,14344,0.358755420447941,-6319
"IL","17143","Peoria",37436,35299,0.514690314154121,2137
"IL","17145","Perry",2433,6816,0.263055465455725,-4383
"IL","17147","Piatt",2633,5623,0.318919573643411,-2990
"IL","17149","Pike",1412,5749,0.1971791649211,-4337
"IL","17151","Pope",374,1678,0.182261208576998,-1304
"IL","17153","Pulaski",817,1583,0.340416666666667,-766
"IL","17155","Putnam",1143,1762,0.393459552495697,-619
"IL","17157","Randolph",3421,9992,0.255051069857601,-6571
"IL","17159","Richland",1579,5736,0.215857826384142,-4157
"IL","17161","Rock Island",32258,26969,0.544650243976565,5289
"IL","17163","St. Clair",60180,53479,0.529478527877247,6701
"IL","17165","Saline",2551,8248,0.236225576442263,-5697
"IL","17167","Sangamon",40731,49823,0.449797910638956,-9092
"IL","17169","Schuyler",1074,2523,0.298582151793161,-1449
"IL","17171","Scott",528,1965,0.21179302045728,-1437
"IL","17173","Shelby",2279,8209,0.217295957284516,-5930
"IL","17175","Stark",748,1777,0.296237623762376,-1029
"IL","17177","Stephenson",7531,10845,0.409828036569438,-3314
"IL","17179","Tazewell",20568,38620,0.347502872203825,-18052
"IL","17181","Union",2389,5780,0.2924470559432,-3391
"IL","17183","Vermilion",9876,18582,0.347037739827114,-8706
"IL","17185","Wabash",1146,4039,0.221022179363549,-2893
"IL","17187","Warren",2983,4267,0.411448275862069,-1284
"IL","17189","Washington",1446,5566,0.206217912150599,-4120
"IL","17191","Wayne",1048,6963,0.130820122331794,-5915
"IL","17193","White",1412,5639,0.20025528293859,-4227
"IL","17195","Whiteside",11005,12597,0.466274044572494,-1592
"IL","17197","Will",146230,129726,0.529903317920248,16504
"IL","17199","Williamson",8539,21503,0.284235403768058,-12964
"IL","17201","Winnebago",52595,53922,0.493770947360515,-1327
"IL","17203","Woodford",5068,13180,0.277729066199036,-8112
"IL","91700103","Chicago",848321,127337,0.86948602891587,720984
"IL","91700104","Cook Suburbs",680261,312876,0.684961893474918,367385
"IN","18001","Adams",2802,9642,0.225168756027001,-6840
"IN","18003","Allen",55222,83801,0.397214849341476,-28579
"IN","18005","Bartholomew",9841,20637,0.322888640986941,-10796
"IN","18007","Benton",860,2579,0.250072695551032,-1719
"IN","18009","Blackford",1243,3349,0.270688153310105,-2106
"IN","18011","Boone",10181,19654,0.341243505949388,-9473
"IN","18013","Brown",2518,5015,0.334262577990177,-2497
"IN","18015","Carroll",1891,6273,0.231626653601176,-4382
"IN","18017","Cass",3758,9697,0.279301374953549,-5939
"IN","18019","Clark",18791,30012,0.385037805052968,-11221
"IN","18021","Clay",2306,8528,0.212848440095994,-6222
"IN","18023","Clinton",2819,8530,0.2483919288043,-5711
"IN","18025","Crawford",1323,3013,0.305119926199262,-1690
"IN","18027","Daviess",1800,8545,0.173997100048333,-6745
"IN","18029","Dearborn",4883,18110,0.212368981864046,-13227
"IN","18031","Decatur",2121,8488,0.199924592327269,-6367
"IN","18033","DeKalb",3941,12054,0.246389496717724,-8113
"IN","18035","Delaware",18100,24217,0.427724082520027,-6117
"IN","18037","Dubois",5389,13365,0.287352031566599,-7976
"IN","18039","Elkhart",20667,41810,0.33079373209341,-21143
"IN","18041","Fayette",2252,6839,0.247717522824772,-4587
"IN","18043","Floyd",13939,21427,0.394135610473336,-7488
"IN","18045","Fountain",1476,5661,0.206809583858764,-4185
"IN","18047","Franklin",1967,8665,0.185007524454477,-6698
"IN","18049","Fulton",1960,6010,0.245922208281054,-4050
"IN","18051","Gibson",3720,11079,0.251368335698358,-7359
"IN","18053","Grant",7029,17009,0.292412014310675,-9980
"IN","18055","Greene",2929,10275,0.221826719176007,-7346
"IN","18057","Hamilton",57214,87299,0.395909018565804,-30085
"IN","18059","Hancock",8901,25050,0.262171953697977,-16149
"IN","18061","Harrison",4776,12993,0.268782711463785,-8217
"IN","18063","Hendricks",22595,48326,0.318593928455606,-25731
"IN","18065","Henry",5124,13895,0.269414795730585,-8771
"IN","18067","Howard",11215,23675,0.321438807681284,-12460
"IN","18069","Huntington",3506,11649,0.231342791158034,-8143
"IN","18071","Jackson",3843,12857,0.230119760479042,-9014
"IN","18073","Jasper",3329,9382,0.261899142475022,-6053
"IN","18075","Jay",1889,5697,0.249011336672818,-3808
"IN","18077","Jefferson",4325,8538,0.336235714841017,-4213
"IN","18079","Jennings",2364,8222,0.223313810693369,-5858
"IN","18081","Johnson",17318,45456,0.275878548443623,-28138
"IN","18083","Knox",3772,11077,0.254023839989225,-7305
"IN","18085","Kosciusko",6311,23909,0.208835208471211,-17598
"IN","18087","LaGrange",2080,7025,0.228445908841296,-4945
"IN","18089","Lake",116896,75565,0.607375000649482,41331
"IN","18091","LaPorte",19795,22678,0.466060791561698,-2883
"IN","18093","Lawrence",4210,14034,0.230760798070599,-9824
"IN","18095","Madison",18595,32376,0.364815287124051,-13781
"IN","18097","Marion",212676,130228,0.620220236567669,82448
"IN","18099","Marshall",4798,12286,0.280847576679934,-7488
"IN","18101","Martin",881,3695,0.192526223776224,-2814
"IN","18103","Miami",2766,9975,0.217094419590299,-7209
"IN","18105","Monroe",34183,20527,0.62480350941327,13656
"IN","18107","Montgomery",3362,11051,0.233261638798307,-7689
"IN","18109","Morgan",6037,23671,0.203211256227279,-17634
"IN","18111","Newton",1403,4074,0.256162132554318,-2671
"IN","18113","Noble",3904,12198,0.24245435349646,-8294
"IN","18115","Ohio",686,2118,0.244650499286733,-1432
"IN","18117","Orange",2048,5800,0.260958205912334,-3752
"IN","18119","Owen",1946,6151,0.240335926886501,-4205
"IN","18121","Parke",1441,4863,0.228585025380711,-3422
"IN","18123","Perry",3062,4556,0.40194276713048,-1494
"IN","18125","Pike",1297,4398,0.22774363476734,-3101
"IN","18127","Porter",33531,38719,0.464096885813149,-5188
"IN","18129","Posey",3515,8393,0.295179711118576,-4878
"IN","18131","Pulaski",1327,3854,0.256128160586759,-2527
"IN","18133","Putnam",3356,10637,0.239834202815694,-7281
"IN","18135","Randolph",2446,7515,0.245557674932236,-5069
"IN","18137","Ripley",2471,9806,0.201270668730146,-7335
"IN","18139","Rush",1525,5292,0.223705442276661,-3767
"IN","18141","St. Joseph",52247,52019,0.501093357374408,228
"IN","18143","Scott",2642,6074,0.303120697567692,-3432
"IN","18145","Shelby",4247,12718,0.250338933097554,-8471
"IN","18147","Spencer",2861,6572,0.303296936287501,-3711
"IN","18149","Starke",2489,6367,0.281052393857272,-3878
"IN","18151","Steuben",3741,10127,0.269757715604269,-6386
"IN","18153","Sullivan",2113,6138,0.256090170888377,-4025
"IN","18155","Switzerland",930,2558,0.266628440366972,-1628
"IN","18157","Tippecanoe",27207,30711,0.469750336682897,-3504
"IN","18159","Tipton",1587,5589,0.221153846153846,-4002
"IN","18161","Union",715,2445,0.22626582278481,-1730
"IN","18163","Vanderburgh",28296,40422,0.411769841962805,-12126
"IN","18165","Vermillion",2081,4511,0.315685679611651,-2430
"IN","18167","Vigo",15922,21924,0.420704962215294,-6002
"IN","18169","Wabash",3018,9819,0.235101659266184,-6801
"IN","18171","Warren",839,2896,0.224631860776439,-2057
"IN","18173","Warrick",9086,19133,0.321981643573479,-10047
"IN","18175","Washington",2636,8206,0.243128574063826,-5570
"IN","18177","Wayne",8322,16028,0.3417659137577,-7706
"IN","18179","Wells",2585,9999,0.20541958041958,-7414
"IN","18181","White",2563,6813,0.273357508532423,-4250
"IN","18183","Whitley",3379,11357,0.229302388707926,-7978
"KS","20001","Allen",1398,3575,0.281118037401971,-2177
"KS","20003","Anderson",665,2386,0.217961324156014,-1721
"KS","20005","Atchison",1946,3977,0.328549721424954,-2031
"KS","20007","Barber",281,1822,0.133618640038041,-1541
"KS","20009","Barton",1823,7766,0.190113671915737,-5943
"KS","20011","Bourbon",1306,4314,0.232384341637011,-3008
"KS","20013","Brown",850,2861,0.229048773915387,-2011
"KS","20015","Butler",6489,18781,0.256786703601108,-12292
"KS","20017","Chase",313,964,0.245105716523101,-651
"KS","20019","Chautauqua",236,1552,0.131991051454139,-1316
"KS","20021","Cherokee",1959,6017,0.24561183550652,-4058
"KS","20023","Cheyenne",188,1172,0.138235294117647,-984
"KS","20025","Clark",118,813,0.126745435016112,-695
"KS","20027","Clay",665,2831,0.190217391304348,-2166
"KS","20029","Cloud",744,2856,0.206666666666667,-2112
"KS","20031","Coffey",719,2990,0.193852790509571,-2271
"KS","20033","Comanche",102,705,0.12639405204461,-603
"KS","20035","Cowley",3436,8016,0.300034928396787,-4580
"KS","20037","Crawford",5064,8394,0.376281765492644,-3330
"KS","20039","Decatur",178,1220,0.127324749642346,-1042
"KS","20041","Dickinson",1582,5905,0.211299585948978,-4323
"KS","20043","Doniphan",584,2601,0.183359497645212,-2017
"KS","20045","Douglas",30089,14308,0.677725972475618,15781
"KS","20047","Edwards",208,1033,0.167606768734891,-825
"KS","20049","Elk",160,1048,0.132450331125828,-888
"KS","20051","Ellis",2669,8311,0.243078324225865,-5642
"KS","20053","Ellsworth",515,1933,0.210375816993464,-1418
"KS","20055","Finney",3006,6155,0.328130116799476,-3149
"KS","20057","Ford",2032,4994,0.289211500142328,-2962
"KS","20059","Franklin",2829,7025,0.287091536431906,-4196
"KS","20061","Geary",2569,4116,0.384293193717277,-1547
"KS","20063","Gove",149,1127,0.116771159874608,-978
"KS","20065","Graham",185,1013,0.154424040066778,-828
"KS","20067","Grant",427,1755,0.195692025664528,-1328
"KS","20069","Gray",257,1651,0.134696016771488,-1394
"KS","20071","Greeley",83,523,0.136963696369637,-440
"KS","20073","Greenwood",484,2146,0.184030418250951,-1662
"KS","20075","Hamilton",114,690,0.141791044776119,-576
"KS","20077","Harper",388,1950,0.16595380667237,-1562
"KS","20079","Harvey",5006,8503,0.370567769635058,-3497
"KS","20081","Haskell",228,1011,0.184019370460048,-783
"KS","20083","Hodgeman",124,845,0.12796697626419,-721
"KS","20085","Jackson",1489,3888,0.27692021573368,-2399
"KS","20087","Jefferson",2483,5112,0.326925608953259,-2629
"KS","20089","Jewell",180,1204,0.130057803468208,-1024
"KS","20091","Johnson",126324,133907,0.485430252352717,-7583
"KS","20093","Kearny",224,1048,0.176100628930818,-824
"KS","20095","Kingman",594,2507,0.191551112544341,-1913
"KS","20097","Kiowa",111,855,0.114906832298137,-744
"KS","20099","Labette",2234,5232,0.299223144923654,-2998
"KS","20101","Lane",104,684,0.131979695431472,-580
"KS","20103","Leavenworth",10064,17387,0.366616880987942,-7323
"KS","20105","Lincoln",214,1168,0.154848046309696,-954
"KS","20107","Linn",721,3377,0.175939482674475,-2656
"KS","20109","Logan",149,1124,0.117046347211312,-975
"KS","20111","Lyon",4456,6354,0.412210915818686,-1898
"KS","20113","McPherson",3183,8407,0.274633304572908,-5224
"KS","20115","Marion",1177,3928,0.230558276199804,-2751
"KS","20117","Marshall",1060,3250,0.245939675174014,-2190
"KS","20119","Meade",206,1390,0.129072681704261,-1184
"KS","20121","Miami",3949,9839,0.28640847113432,-5890
"KS","20123","Mitchell",469,2216,0.174674115456238,-1747
"KS","20125","Montgomery",2557,8466,0.23196951827996,-5909
"KS","20127","Morris",586,1790,0.246632996632997,-1204
"KS","20129","Morton",145,970,0.130044843049327,-825
"KS","20131","Nemaha",714,4066,0.149372384937239,-3352
"KS","20133","Neosho",1464,4340,0.25223983459683,-2876
"KS","20135","Ness",160,1216,0.116279069767442,-1056
"KS","20137","Norton",277,1808,0.132853717026379,-1531
"KS","20139","Osage",1730,4713,0.268508458792488,-2983
"KS","20141","Osborne",231,1437,0.138489208633094,-1206
"KS","20143","Ottawa",424,2261,0.157914338919926,-1837
"KS","20145","Pawnee",567,1872,0.232472324723247,-1305
"KS","20147","Phillips",296,2200,0.118589743589744,-1904
"KS","20149","Pottawatomie",2191,7451,0.22723501348268,-5260
"KS","20151","Pratt",769,2824,0.214027275257445,-2055
"KS","20153","Rawlins",160,1209,0.116873630387144,-1049
"KS","20155","Reno",6670,15100,0.30638493339458,-8430
"KS","20157","Republic",370,1993,0.156580617858654,-1623
"KS","20159","Rice",668,2652,0.201204819277108,-1984
"KS","20161","Riley",8892,9817,0.475279277353146,-925
"KS","20163","Rooks",273,1999,0.120158450704225,-1726
"KS","20165","Rush",227,1177,0.161680911680912,-950
"KS","20167","Russell",454,2544,0.151434289526351,-2090
"KS","20169","Saline",6084,13367,0.312785975014138,-7283
"KS","20171","Scott",232,1832,0.112403100775194,-1600
"KS","20173","Sedgwick",66716,101319,0.397036331716607,-34603
"KS","20175","Seward",1491,3025,0.330159433126661,-1534
"KS","20177","Shawnee",33270,35349,0.484851134525423,-2079
"KS","20179","Sheridan",126,1186,0.0960365853658537,-1060
"KS","20181","Sherman",340,2043,0.142677297524129,-1703
"KS","20183","Smith",295,1635,0.152849740932642,-1340
"KS","20185","Stafford",303,1485,0.169463087248322,-1182
"KS","20187","Stanton",132,580,0.185393258426966,-448
"KS","20189","Stevens",215,1564,0.120854412591343,-1349
"KS","20191","Sumner",2039,6844,0.229539569965102,-4805
"KS","20193","Thomas",467,2832,0.141558047893301,-2365
"KS","20195","Trego",193,1211,0.137464387464387,-1018
"KS","20197","Wabaunsee",773,2358,0.246885978920473,-1585
"KS","20199","Wallace",45,711,0.0595238095238095,-666
"KS","20201","Washington",378,2136,0.15035799522673,-1758
"KS","20203","Wichita",139,765,0.153761061946903,-626
"KS","20205","Wilson",550,2747,0.166818319684562,-2197
"KS","20207","Woodson",270,1063,0.202550637659415,-793
"KS","20209","Wyandotte",29346,15520,0.654081041323051,13826
"KY","21001","Adair",1323,6637,0.166206030150754,-5314
"KY","21003","Allen",1349,6466,0.172616762635956,-5117
"KY","21005","Anderson",2634,8242,0.242184626700993,-5608
"KY","21007","Ballard",816,3161,0.2051797837566,-2345
"KY","21009","Barren",4275,13483,0.240736569433495,-9208
"KY","21011","Bath",1361,3082,0.306324555480531,-1721
"KY","21013","Bell",1720,7764,0.18135807676086,-6044
"KY","21015","Boone",15026,39082,0.277703851556147,-24056
"KY","21017","Bourbon",2791,5569,0.333851674641148,-2778
"KY","21019","Boyd",6021,13591,0.307005914746074,-7570
"KY","21021","Boyle",4281,8040,0.34745556367178,-3759
"KY","21023","Bracken",705,2711,0.206381733021077,-2006
"KY","21025","Breathitt",1537,3991,0.278039073806078,-2454
"KY","21027","Breckinridge",1960,6484,0.232117479867361,-4524
"KY","21029","Bullitt",8255,26210,0.239518351951255,-17955
"KY","21031","Butler",947,4428,0.176186046511628,-3481
"KY","21033","Caldwell",1260,4507,0.218484480665857,-3247
"KY","21035","Calloway",4749,10367,0.314170415453824,-5618
"KY","21037","Campbell",14658,25050,0.369144756724086,-10392
"KY","21039","Carlisle",432,2094,0.171021377672209,-1662
"KY","21041","Carroll",1106,2588,0.299404439631835,-1482
"KY","21043","Carter",2276,7587,0.230761431613099,-5311
"KY","21045","Casey",767,5482,0.122739638342135,-4715
"KY","21047","Christian",7188,14108,0.337528174305034,-6920
"KY","21049","Clark",4706,10710,0.305267254800208,-6004
"KY","21051","Clay",752,5861,0.113715409042794,-5109
"KY","21053","Clinton",547,3809,0.125573921028466,-3262
"KY","21055","Crittenden",617,3290,0.157921679037625,-2673
"KY","21057","Cumberland",459,2502,0.155015197568389,-2043
"KY","21059","Daviess",14163,28907,0.328836777339215,-14744
"KY","21061","Edmonson",979,4135,0.191435275713727,-3156
"KY","21063","Elliott",740,2000,0.27007299270073,-1260
"KY","21065","Estill",1108,4236,0.207335329341317,-3128
"KY","21067","Fayette",69776,56890,0.550866057189775,12886
"KY","21069","Fleming",1348,4722,0.222075782537068,-3374
"KY","21071","Floyd",4015,11993,0.250812093953024,-7978
"KY","21073","Franklin",10717,11819,0.475550230741924,-1102
"KY","21075","Fulton",774,1549,0.333189840723203,-775
"KY","21077","Gallatin",749,2443,0.234649122807018,-1694
"KY","21079","Garrard",1453,5904,0.197498980562729,-4451
"KY","21081","Grant",1910,7268,0.208106341250817,-5358
"KY","21083","Graves",3308,12671,0.207021716002253,-9363
"KY","21085","Grayson",1959,8219,0.19247396345058,-6260
"KY","21087","Green",832,4372,0.159877017678709,-3540
"KY","21089","Greenup",4146,11546,0.264211062962019,-7400
"KY","21091","Hancock",1244,2788,0.308531746031746,-1544
"KY","21093","Hardin",13944,26970,0.340812435841032,-13026
"KY","21095","Harlan",1372,9129,0.130654223407295,-7757
"KY","21097","Harrison",2031,5435,0.27203321725154,-3404
"KY","21099","Hart",1730,5320,0.245390070921986,-3590
"KY","21101","Henderson",6707,12159,0.355507261740698,-5452
"KY","21103","Henry",1828,4944,0.269935026580035,-3116
"KY","21105","Hickman",449,1657,0.213200379867047,-1208
"KY","21107","Hopkins",4310,15277,0.220043906672793,-10967
"KY","21109","Jackson",482,4889,0.089741202755539,-4407
"KY","21111","Jefferson",190824,143758,0.570335523130354,47066
"KY","21113","Jessamine",6144,15474,0.2842076047738,-9330
"KY","21115","Johnson",1250,8043,0.134509846120736,-6793
"KY","21117","Kenton",24213,42958,0.360468059132661,-18745
"KY","21119","Knott",1245,4357,0.222242056408426,-3112
"KY","21121","Knox",1761,9885,0.151210716125708,-8124
"KY","21123","LaRue",1278,4799,0.210301135428665,-3521
"KY","21125","Laurel",3440,20592,0.143142476697736,-17152
"KY","21127","Lawrence",1045,4816,0.178297218904624,-3771
"KY","21129","Lee",444,2151,0.171098265895954,-1707
"KY","21131","Leslie",400,4015,0.0906002265005662,-3615
"KY","21133","Letcher",1542,7293,0.174533106960951,-5751
"KY","21135","Lewis",785,4363,0.152486402486402,-3578
"KY","21137","Lincoln",1865,7338,0.202651309355645,-5473
"KY","21139","Livingston",887,3570,0.199012788871438,-2683
"KY","21141","Logan",2755,7778,0.261558910092092,-5023
"KY","21143","Lyon",1045,2789,0.272561293688054,-1744
"KY","21145","McCracken",9134,20774,0.305403236592216,-11640
"KY","21147","McCreary",664,5012,0.116983791402396,-4348
"KY","21149","McLean",988,3381,0.226138704509041,-2393
"KY","21151","Madison",11793,23431,0.334800136270725,-11638
"KY","21153","Magoffin",1172,3824,0.234587670136109,-2652
"KY","21155","Marion",2679,5122,0.343417510575567,-2443
"KY","21157","Marshall",3672,12322,0.229586094785545,-8650
"KY","21159","Martin",363,3503,0.0938954992240041,-3140
"KY","21161","Mason",1970,4944,0.284929129302864,-2974
"KY","21163","Meade",3026,8660,0.258942324148554,-5634
"KY","21165","Menifee",700,2010,0.25830258302583,-1310
"KY","21167","Mercer",2395,7740,0.236309817464233,-5345
"KY","21169","Metcalfe",976,3491,0.218491157376315,-2515
"KY","21171","Monroe",601,4278,0.123180979708957,-3677
"KY","21173","Montgomery",3158,7856,0.28672598510986,-4698
"KY","21175","Morgan",1006,3628,0.217091066033664,-2622
"KY","21177","Muhlenberg",3272,9393,0.258349782866167,-6121
"KY","21179","Nelson",6434,13430,0.323902537253323,-6996
"KY","21181","Nicholas",787,1957,0.286807580174927,-1170
"KY","21183","Ohio",2080,7942,0.207543404510078,-5862
"KY","21185","Oldham",10268,20469,0.334059927774344,-10201
"KY","21187","Owen",1062,3745,0.220927813605159,-2683
"KY","21189","Owsley",256,1474,0.147976878612717,-1218
"KY","21191","Pendleton",1164,4604,0.201803051317614,-3440
"KY","21193","Perry",2136,8158,0.207499514280163,-6022
"KY","21195","Pike",4277,19740,0.178082191780822,-15463
"KY","21197","Powell",1272,3513,0.265830721003135,-2241
"KY","21199","Pulaski",4208,22900,0.155230928139295,-18692
"KY","21201","Robertson",222,759,0.226299694189602,-537
"KY","21203","Rockcastle",915,5609,0.140251379521766,-4694
"KY","21205","Rowan",3295,5174,0.389066005431574,-1879
"KY","21207","Russell",1093,6863,0.137380593262946,-5770
"KY","21209","Scott",7713,15052,0.338809576103668,-7339
"KY","21211","Shelby",6276,13196,0.322308956450288,-6920
"KY","21213","Simpson",2144,5077,0.29691178507132,-2933
"KY","21215","Spencer",1921,7196,0.210705275858287,-5275
"KY","21217","Taylor",2553,8320,0.234801802630369,-5767
"KY","21219","Todd",1042,3612,0.223893425010743,-2570
"KY","21221","Trigg",1587,4928,0.24359171143515,-3341
"KY","21223","Trimble",879,2771,0.240821917808219,-1892
"KY","21225","Union",1331,4701,0.22065649867374,-3370
"KY","21227","Warren",16966,28673,0.371743465018953,-11707
"KY","21229","Washington",1420,4013,0.26136572795877,-2593
"KY","21231","Wayne",1431,6370,0.183438020766568,-4939
"KY","21233","Webster",1240,4397,0.219975164094376,-3157
"KY","21235","Whitley",2067,11312,0.1544958517079,-9245
"KY","21237","Wolfe",753,1804,0.294485725459523,-1051
"KY","21239","Woodford",4958,7697,0.391781904385618,-2739
"LA","22001","Acadia",5638,21159,0.210396686196216,-15521
"LA","22003","Allen",2106,6867,0.234704112337011,-4761
"LA","22005","Ascension",16471,36135,0.313101167167243,-19664
"LA","22007","Assumption",3931,6714,0.369281352747769,-2783
"LA","22009","Avoyelles",5032,11163,0.310713183081198,-6131
"LA","22011","Beauregard",2393,12238,0.163556831385415,-9845
"LA","22013","Bienville",3129,3756,0.454466230936819,-627
"LA","22015","Bossier",12638,35451,0.262804383538855,-22813
"LA","22017","Caddo",53448,48977,0.521825726141079,4471
"LA","22019","Calcasieu",26293,54182,0.326722584653619,-27889
"LA","22021","Caldwell",788,3822,0.170932754880694,-3034
"LA","22023","Cameron",323,3256,0.0902486728136351,-2933
"LA","22025","Catahoula",1322,3479,0.275359300145803,-2157
"LA","22027","Claiborne",2717,3585,0.431132973659156,-868
"LA","22029","Concordia",3272,5474,0.374113880631146,-2202
"LA","22031","DeSoto",5163,8067,0.390249433106576,-2904
"LA","22033","East Baton Rouge",102711,84620,0.548286188618008,18091
"LA","22035","East Carroll",1838,1059,0.634449430445288,779
"LA","22037","East Feliciana",4235,5569,0.431966544267646,-1334
"LA","22039","Evangeline",4208,10357,0.288911774802609,-6149
"LA","22041","Franklin",2506,6514,0.277827050997783,-4008
"LA","22043","Grant",1181,7406,0.137533480843135,-6225
"LA","22045","Iberia",10698,20903,0.338533590709155,-10205
"LA","22047","Iberville",8324,7320,0.532088979800562,1004
"LA","22049","Jackson",2139,5169,0.292692939244663,-3030
"LA","22051","Jefferson",73540,100292,0.423052142298311,-26752
"LA","22053","Jeff Davis",3080,10775,0.222302417899675,-7695
"LA","22055","Lafayette",32726,68191,0.324286294677805,-35465
"LA","22057","Lafourche",8423,31958,0.208588197419579,-23535
"LA","22059","LaSalle",605,5835,0.093944099378882,-5230
"LA","22061","Lincoln",7102,10761,0.397581593237418,-3659
"LA","22063","Livingston",6950,48797,0.12467038585036,-41847
"LA","22065","Madison",2744,1927,0.587454506529651,817
"LA","22067","Morehouse",5155,6502,0.442223556661234,-1347
"LA","22069","Natchitoches",7143,8965,0.4434442513037,-1822
"LA","22071","Orleans",133833,24267,0.846508538899431,109566
"LA","22073","Ouachita",24420,41712,0.369261477045908,-17292
"LA","22075","Plaquemines",3347,6900,0.326632185029765,-3553
"LA","22077","Pointe Coupee",4764,6789,0.412360425863412,-2025
"LA","22079","Rapides",18318,36814,0.332257128346514,-18496
"LA","22081","Red River",1938,2391,0.447678447678448,-453
"LA","22083","Richland",3157,6286,0.334321719792439,-3129
"LA","22085","Sabine",1703,7877,0.17776617954071,-6174
"LA","22087","St. Bernard",4957,10232,0.32635459872276,-5275
"LA","22089","St. Charles",8558,16620,0.33989991262213,-8062
"LA","22091","St. Helena",3353,2497,0.573162393162393,856
"LA","22093","St. James",6418,5456,0.540508674414688,962
"LA","22095","St. John the Baptist",12658,7569,0.625797201760024,5089
"LA","22097","St. Landry",17208,21966,0.43927094501455,-4758
"LA","22099","St. Martin",8266,16872,0.328824886625825,-8606
"LA","22101","St. Mary",8050,14353,0.35932687586484,-6303
"LA","22103","St. Tammany",27716,90914,0.233633988030009,-63198
"LA","22105","Tangipahoa",16869,33933,0.332053856147396,-17064
"LA","22107","Tensas",1329,1180,0.529693104822639,149
"LA","22109","Terrebonne",10664,31900,0.250540362747862,-21236
"LA","22111","Union",2691,7972,0.252368001500516,-5281
"LA","22113","Vermilion",4745,19807,0.193263277940697,-15062
"LA","22115","Vernon",2665,13471,0.165158651462568,-10806
"LA","22117","Washington",5690,12552,0.311917552899901,-6862
"LA","22119","Webster",6259,11538,0.351688486823622,-5279
"LA","22121","West Baton Rouge",5382,6926,0.437276568085798,-1544
"LA","22123","West Carroll",715,3970,0.152614727854856,-3255
"LA","22125","West Feliciana",2247,3390,0.398616285258116,-1143
"LA","22127","Winn",1643,4605,0.262964148527529,-2962
"MA","25001","Barnstable",71632,53842,0.570891180643002,17790
"MA","25003","Berkshire",43540,16799,0.721589684946718,26741
"MA","25005","Bristol",127619,104775,0.549149289568577,22844
"MA","25007","Dukes",8338,2474,0.77118017018128,5864
"MA","25009","Essex",220027,135405,0.619041054266358,84622
"MA","25011","Franklin",24369,10327,0.702357620474983,14042
"MA","25013","Hampden",110313,78230,0.585081387269747,32083
"MA","25015","Hampshire",54572,22089,0.71186131148824,32483
"MA","25017","Middlesex",508919,216163,0.701877856573463,292756
"MA","25019","Nantucket",4144,1892,0.686547382372432,2252
"MA","25021","Norfolk",219129,119171,0.647735737511085,99958
"MA","25023","Plymouth",133828,114722,0.538434922550795,19106
"MA","25025","Suffolk",241212,50042,0.828184333949062,191170
"MA","25027","Worcester",197126,157138,0.556438136530949,39988
"MD","24001","Allegany",6665,20025,0.249718995878606,-13360
"MD","24003","Anne Arundel",116074,114509,0.503393571945894,1565
"MD","24005","Baltimore",189437,131009,0.591166686430787,58428
"MD","24009","Calvert",16669,24680,0.403129458995381,-8011
"MD","24011","Caroline",3747,8999,0.293974580260474,-5252
"MD","24013","Carroll",24314,55593,0.304278724016669,-31279
"MD","24015","Cecil",12651,27579,0.314466815809098,-14928
"MD","24017","Charles",46063,24163,0.655925155925156,21900
"MD","24019","Dorchester",5695,7938,0.417736374972493,-2243
"MD","24021","Frederick",51891,56472,0.478862711442097,-4581
"MD","24023","Garrett",2252,10189,0.18101438791094,-7937
"MD","24025","Harford",43803,74261,0.371010638297872,-30458
"MD","24027","Howard",93808,44792,0.676825396825397,49016
"MD","24029","Kent",4178,4598,0.476071103008204,-420
"MD","24031","Montgomery",309761,82985,0.788705677460751,226776
"MD","24033","Prince George's",313627,29290,0.914585745238644,284337
"MD","24035","Queen Anne's",7316,16211,0.310961873592043,-8895
"MD","24037","St. Mary's",15786,26889,0.369912126537786,-11103
"MD","24039","Somerset",3484,5056,0.407962529274005,-1572
"MD","24041","Talbot",7865,10098,0.437844458052664,-2233
"MD","24043","Washington",19193,38842,0.330714224175067,-19649
"MD","24045","Wicomico",16327,20832,0.439382114696305,-4505
"MD","24047","Worcester",8783,15910,0.355687846758191,-7127
"MD","24510","Baltimore City",178562,22726,0.887097094710067,155836
"ME","23001","Androscoggin",22975,28189,0.449046204362442,-5214
"ME","23003","Aroostook",13377,19419,0.407885107939993,-6042
"ME","23005","Cumberland",102935,57697,0.640812540465163,45238
"ME","23007","Franklin",7001,7900,0.469834239312798,-899
"ME","23009","Hancock",16107,13682,0.540702944039746,2425
"ME","23011","Kennebec",29296,31753,0.479876820259136,-2457
"ME","23013","Knox",12440,9148,0.576246062627386,3292
"ME","23015","Lincoln",10241,9727,0.512870592948718,514
"ME","23017","Oxford",12172,16214,0.428802931022335,-4042
"ME","23019","Penobscot",32832,41601,0.44109467574866,-8769
"ME","23021","Piscataquis",3098,5403,0.364427714386543,-2305
"ME","23023","Sagadahoc",10679,9304,0.534404243607066,1375
"ME","23025","Somerset",9092,14998,0.37741801577418,-5906
"ME","23027","Waldo",10442,10378,0.501536983669548,64
"ME","23029","Washington",6358,9037,0.41299123091913,-2679
"ME","23031","York",55828,50388,0.525608194622279,5440
"MI","26001","Alcona",1732,4201,0.291926512725434,-2469
"MI","26003","Alger",1663,2585,0.391478342749529,-922
"MI","26005","Allegan",17932,33812,0.346552257266543,-15880
"MI","26007","Alpena",4877,9090,0.34918021049617,-4213
"MI","26009","Antrim",4448,8469,0.344352403808934,-4021
"MI","26011","Arenac",2238,4704,0.32238547968885,-2466
"MI","26013","Baraga",1156,2158,0.348823174411587,-1002
"MI","26015","Barry",9109,19197,0.321804564403307,-10088
"MI","26017","Bay",21641,28327,0.433097182196606,-6686
"MI","26019","Benzie",4108,5539,0.425831864828444,-1431
"MI","26021","Berrien",29496,38646,0.43286079070177,-9150
"MI","26023","Branch",4740,11025,0.300666032350143,-6285
"MI","26025","Calhoun",24154,31489,0.434088744316446,-7335
"MI","26027","Cass",7270,14241,0.337966621728418,-6971
"MI","26029","Charlevoix",5137,8674,0.371949895011223,-3537
"MI","26031","Cheboygan",4302,8680,0.33138191341858,-4378
"MI","26033","Chippewa",5378,9120,0.370947716926473,-3742
"MI","26035","Clare",4250,8507,0.33315042721643,-4257
"MI","26037","Clinton",16490,21635,0.432524590163934,-5145
"MI","26039","Crawford",2110,4354,0.326423267326733,-2244
"MI","26041","Delta",6431,11112,0.36658496266317,-4681
"MI","26043","Dickinson",3923,8580,0.313764696472846,-4657
"MI","26045","Eaton",24534,27608,0.470522803114572,-3074
"MI","26047","Emmet",6972,10616,0.396406640891517,-3644
"MI","26049","Genesee",102744,84174,0.549674188681668,18570
"MI","26051","Gladwin",3794,8124,0.318342003691895,-4330
"MI","26053","Gogebic",2925,4019,0.421226958525346,-1094
"MI","26055","Grand Traverse",20964,27412,0.433355382834463,-6448
"MI","26057","Gratiot",5665,9878,0.364472753007785,-4213
"MI","26059","Hillsdale",4799,14094,0.254009421478855,-9295
"MI","26061","Houghton",6018,8475,0.415234941006003,-2457
"MI","26063","Huron",4579,10629,0.301091530773277,-6050
"MI","26065","Ingham",81266,44354,0.646919280369368,36912
"MI","26067","Ionia",8206,16374,0.333848657445077,-8168
"MI","26069","Iosco",4344,8344,0.342370744010088,-4000
"MI","26071","Iron",2004,3675,0.352879027997887,-1671
"MI","26073","Isabella",11404,12338,0.480330216493977,-934
"MI","26075","Jackson",25795,39793,0.393288406415808,-13998
"MI","26077","Kalamazoo",67142,51031,0.568167009384546,16111
"MI","26079","Kalkaska",2279,6213,0.268370230805464,-3934
"MI","26081","Kent",138567,147959,0.483610562392244,-9392
"MI","26083","Keweenaw",527,814,0.392990305741984,-287
"MI","26085","Lake",1939,3159,0.380345233424872,-1220
"MI","26087","Lapeer",12734,30037,0.297725094105819,-17303
"MI","26089","Leelanau",6774,7239,0.483408263755085,-465
"MI","26091","Lenawee",16750,26428,0.387929037935986,-9678
"MI","26093","Livingston",34378,65665,0.343632238137601,-31287
"MI","26095","Luce",681,1756,0.27944193680755,-1075
"MI","26097","Mackinac",2085,3740,0.35793991416309,-1655
"MI","26099","Macomb",176238,224589,0.439685949299823,-48351
"MI","26101","Manistee",4979,6915,0.418614427442408,-1936
"MI","26103","Marquette",16042,14646,0.522745046923879,1396
"MI","26105","Mason",5281,8505,0.383069780937183,-3224
"MI","26107","Mecosta",5827,10305,0.361207537813042,-4478
"MI","26109","Menominee",3539,6704,0.345504246802695,-3165
"MI","26111","Midland",15655,23877,0.396008297075787,-8222
"MI","26113","Missaukee",1565,5386,0.225147460797008,-3821
"MI","26115","Monroe",26859,43255,0.383076133154577,-16396
"MI","26117","Montcalm",7874,16907,0.317743432468423,-9033
"MI","26119","Montmorency",1286,3498,0.2688127090301,-2212
"MI","26121","Muskegon",36640,35962,0.504669292856946,678
"MI","26123","Newaygo",6212,15174,0.290470401197045,-8962
"MI","26125","Oakland",342976,289127,0.542595115036632,53849
"MI","26127","Oceana",3973,7228,0.354700473172038,-3255
"MI","26129","Ogemaw",3030,6827,0.307395759358831,-3797
"MI","26131","Ontonagon",1175,2069,0.362207151664612,-894
"MI","26133","Osceola",2705,7336,0.269395478537994,-4631
"MI","26135","Oscoda",1044,2843,0.268587599691279,-1799
"MI","26137","Otsego",3556,8266,0.300795127727965,-4710
"MI","26139","Ottawa",46276,90456,0.338443085744376,-44180
"MI","26141","Presque Isle",2400,4486,0.348533255881499,-2086
"MI","26143","Roscommon",4287,8141,0.344946894110074,-3854
"MI","26145","Saginaw",44395,45469,0.494024303391792,-1074
"MI","26147","St. Clair",24553,49067,0.333509915783754,-24514
"MI","26149","St. Joseph",7529,14886,0.335891144322998,-7357
"MI","26151","Sanilac",4873,13446,0.266007969867351,-8573
"MI","26153","Schoolcraft",1369,2556,0.348789808917197,-1187
"MI","26155","Shiawassee",12547,19232,0.394820478932628,-6685
"MI","26157","Tuscola",7493,17421,0.300754595809585,-9928
"MI","26159","Van Buren",13258,17890,0.425645306279697,-4632
"MI","26161","Washtenaw",128025,50335,0.717789863198027,77690
"MI","26163","Wayne",517842,228908,0.693460997656512,288934
"MI","26165","Wexford",4436,10000,0.307287337212524,-5564
"MN","27001","Aitkin",3134,5516,0.362312138728324,-2382
"MN","27003","Anoka",75499,93341,0.447162994551054,-17842
"MN","27005","Becker",5208,10880,0.323719542516161,-5672
"MN","27007","Beltrami",8688,10783,0.446202044065533,-2095
"MN","27009","Benton",5640,12872,0.30466724286949,-7232
"MN","27011","Big Stone",921,1607,0.364319620253165,-686
"MN","27013","Blue Earth",14428,15667,0.479415185246719,-1239
"MN","27015","Brown",3763,8708,0.301740036885575,-4945
"MN","27017","Carlton",8460,8160,0.509025270758123,300
"MN","27019","Carver",21508,29057,0.425353505389103,-7549
"MN","27021","Cass",4949,9982,0.3314580403188,-5033
"MN","27023","Chippewa",1978,3764,0.344479275513758,-1786
"MN","27025","Chisago",9279,18441,0.33474025974026,-9162
"MN","27027","Clay",12974,13549,0.48916035139313,-575
"MN","27029","Clearwater",1100,2925,0.273291925465839,-1825
"MN","27031","Cook",1912,1156,0.623207301173403,756
"MN","27033","Cottonwood",1678,3679,0.313235019600523,-2001
"MN","27035","Crow Wing",10982,22287,0.330097087378641,-11305
"MN","27037","Dakota",110251,99624,0.525317450863609,10627
"MN","27039","Dodge",3102,6527,0.322151833004466,-3425
"MN","27041","Douglas",6227,13966,0.308374189075422,-7739
"MN","27043","Faribault",2153,4659,0.316059894304169,-2506
"MN","27045","Fillmore",3872,6271,0.381741102237997,-2399
"MN","27047","Freeborn",6041,8808,0.406828742676275,-2767
"MN","27049","Goodhue",9446,14041,0.402179929322604,-4595
"MN","27051","Grant",1104,2063,0.348594884748974,-959
"MN","27053","Hennepin",429283,191768,0.691220205747998,237515
"MN","27055","Houston",4145,5616,0.424649113820305,-1471
"MN","27057","Hubbard",3432,7269,0.32071768993552,-3837
"MN","27059","Isanti",5656,13635,0.293193717277487,-7979
"MN","27061","Itasca",9015,12920,0.410987007066332,-3905
"MN","27063","Jackson",1492,3609,0.292491668300333,-2117
"MN","27065","Kanabec",2327,5230,0.307926425830356,-2903
"MN","27067","Kandiyohi",7266,12785,0.362375941349559,-5519
"MN","27069","Kittson",823,1349,0.378913443830571,-526
"MN","27071","Koochiching",2306,3569,0.392510638297872,-1263
"MN","27073","Lac Qui Parle",1301,2294,0.361891515994437,-993
"MN","27075","Lake",3077,2932,0.512065235480113,145
"MN","27077","Lake of the Woods",553,1540,0.264214046822742,-987
"MN","27079","Le Sueur",4623,9182,0.334878667149583,-4559
"MN","27081","Lincoln",860,1930,0.308243727598566,-1070
"MN","27083","Lyon",3825,7256,0.345185452576482,-3431
"MN","27085","McLeod",4978,12155,0.290550399813226,-7177
"MN","27087","Mahnomen",930,991,0.484122852680895,-61
"MN","27089","Marshall",1225,3208,0.276336566659147,-1983
"MN","27091","Martin",2733,7062,0.279019908116386,-4329
"MN","27093","Meeker",3192,8103,0.282602921646746,-4911
"MN","27095","Mille Lacs",3709,8340,0.307826375632833,-4631
"MN","27097","Morrison",3637,12925,0.219599082236445,-9288
"MN","27099","Mower",7444,8826,0.457529194837124,-1382
"MN","27101","Murray",1295,2974,0.303349730616069,-1679
"MN","27103","Nicollet",7886,8436,0.483151574561941,-550
"MN","27105","Nobles",2733,5299,0.340263944223108,-2566
"MN","27107","Norman",1264,1699,0.426594667566655,-435
"MN","27109","Olmsted",36266,35668,0.504156587983429,598
"MN","27111","Otter Tail",9339,20939,0.308441772904419,-11600
"MN","27113","Pennington",2146,4000,0.349170191994793,-1854
"MN","27115","Pine",4580,8191,0.3586250097878,-3611
"MN","27117","Pipestone",1127,3338,0.252407614781635,-2211
"MN","27119","Polk",4712,8979,0.344167701409685,-4267
"MN","27121","Pope",2106,3793,0.357009662654687,-1687
"MN","27123","Ramsey",176929,70778,0.714267259302321,106151
"MN","27125","Red Lake",540,1141,0.321237358715051,-601
"MN","27127","Redwood",1887,5137,0.268650341685649,-3250
"MN","27129","Renville",2117,4890,0.302126444983588,-2773
"MN","27131","Rice",14437,15429,0.483392486439429,-992
"MN","27133","Rock",1373,3091,0.307571684587814,-1718
"MN","27135","Roseau",1856,5451,0.254003010811551,-3595
"MN","27137","St. Louis",57769,44631,0.564150390625,13138
"MN","27139","Scott",28502,39948,0.416391526661797,-11446
"MN","27141","Sherburne",13299,31049,0.299878235771624,-17750
"MN","27143","Sibley",1954,5193,0.27340142717224,-3239
"MN","27145","Stearns",25575,47618,0.349418660254396,-22043
"MN","27147","Steele",6239,11198,0.357802374261628,-4959
"MN","27149","Stevens",2116,2800,0.430431244914565,-684
"MN","27151","Swift",1679,2962,0.361775479422538,-1283
"MN","27153","Todd",2783,8485,0.246982605608804,-5702
"MN","27155","Traverse",631,1050,0.375371802498513,-419
"MN","27157","Wabasha",3866,6989,0.356149239981575,-3123
"MN","27159","Wadena",1684,4837,0.258242600828094,-3153
"MN","27161","Waseca",2838,5967,0.322316865417376,-3129
"MN","27163","Washington",67086,64429,0.510101509333536,2657
"MN","27165","Watonwan",1814,2768,0.395896988214753,-954
"MN","27167","Wilkin",893,2129,0.295499669093316,-1236
"MN","27169","Winona",11366,12122,0.483906675749319,-756
"MN","27171","Wright",20336,43274,0.319698160666562,-22938
"MN","27173","Yellow Medicine",1524,3382,0.310640032613127,-1858
"MO","29001","Adair",3495,6019,0.367353373975194,-2524
"MO","29003","Andrew",2045,6665,0.234787600459242,-4620
"MO","29005","Atchison",541,2059,0.208076923076923,-1518
"MO","29007","Audrain",2567,6981,0.268852115626309,-4414
"MO","29009","Barry",2710,11427,0.191695550682606,-8717
"MO","29011","Barton",795,4958,0.13818877107596,-4163
"MO","29013","Bates",1617,6000,0.212288302481292,-4383
"MO","29015","Benton",2024,7212,0.219142485924643,-5188
"MO","29017","Bollinger",705,4827,0.127440347071584,-4122
"MO","29019","Boone",41072,36146,0.531896708021446,4926
"MO","29021","Buchanan",12010,21315,0.360390097524381,-9305
"MO","29023","Butler",3036,13647,0.181981657975184,-10611
"MO","29025","Caldwell",837,3231,0.205752212389381,-2394
"MO","29027","Callaway",4988,13052,0.27649667405765,-8064
"MO","29029","Camden",4706,16721,0.219629439492229,-12015
"MO","29031","Cape Girardeau",8468,26939,0.239161747677013,-18471
"MO","29033","Carroll",745,3480,0.176331360946746,-2735
"MO","29035","Carter",436,2323,0.158028271112722,-1887
"MO","29037","Cass",14816,33006,0.309815566057463,-18190
"MO","29039","Cedar",1010,5019,0.167523635760491,-4009
"MO","29041","Chariton",888,2948,0.231491136600626,-2060
"MO","29043","Christian",8505,30941,0.215611215332353,-22436
"MO","29045","Clark",724,2458,0.227529855436832,-1734
"MO","29047","Clay",45182,57328,0.44075699931714,-12146
"MO","29049","Clinton",2572,7058,0.267082035306334,-4486
"MO","29051","Cole",10907,24610,0.307092378297717,-13703
"MO","29053","Cooper",1932,5623,0.25572468563865,-3691
"MO","29055","Crawford",1824,7724,0.191034771679933,-5900
"MO","29057","Dade",637,3184,0.166710285265637,-2547
"MO","29059","Dallas",1271,5895,0.177365336310354,-4624
"MO","29061","Daviess",730,2763,0.208989407386201,-2033
"MO","29063","DeKalb",824,3540,0.188817598533456,-2716
"MO","29065","Dent",978,5599,0.148700015204501,-4621
"MO","29067","Douglas",984,5486,0.152086553323029,-4502
"MO","29069","Dunklin",2360,8026,0.227228962064317,-5666
"MO","29071","Franklin",12339,35420,0.258359680897841,-23081
"MO","29073","Gasconade",1519,5670,0.211295034079844,-4151
"MO","29075","Gentry",605,2304,0.207975249226538,-1699
"MO","29077","Greene",42400,77387,0.353961615200314,-34987
"MO","29079","Grundy",780,3462,0.183875530410184,-2682
"MO","29081","Harrison",574,2965,0.16219270980503,-2391
"MO","29083","Henry",2356,7072,0.249893932965634,-4716
"MO","29085","Hickory",1016,3539,0.223051591657519,-2523
"MO","29087","Holt",346,1926,0.152288732394366,-1580
"MO","29089","Howard",1279,3277,0.280728709394205,-1998
"MO","29091","Howell",2880,13888,0.17175572519084,-11008
"MO","29093","Iron",933,3173,0.227228446176327,-2240
"MO","29095","Jackson",163723,114777,0.587874326750449,48946
"MO","29097","Jasper",10565,35058,0.231571794927997,-24493
"MO","29099","Jefferson",31546,68973,0.313831215989017,-37427
"MO","29101","Johnson",5924,13702,0.301844492000408,-7778
"MO","29103","Knox",379,1413,0.211495535714286,-1034
"MO","29105","LaClede",2543,12834,0.165376861546465,-10291
"MO","29107","Lafayette",4047,10977,0.269369009584665,-6930
"MO","29109","Lawrence",2898,13084,0.181328995119509,-10186
"MO","29111","Lewis",933,3343,0.218194574368569,-2410
"MO","29113","Lincoln",5561,18111,0.234918891517405,-12550
"MO","29115","Linn",1239,4084,0.232763479241029,-2845
"MO","29117","Livingston",1265,4879,0.205891927083333,-3614
"MO","29119","McDonald",1329,6599,0.16763370332997,-5270
"MO","29121","Macon",1518,5794,0.207603938730853,-4276
"MO","29123","Madison",1005,4102,0.196788721362835,-3097
"MO","29125","Maries",794,3559,0.182402940500804,-2765
"MO","29127","Marion",2993,9418,0.241157038111353,-6425
"MO","29129","Mercer",216,1486,0.126909518213866,-1270
"MO","29131","Miller",1750,9285,0.158586316266425,-7535
"MO","29133","Mississippi",1458,3600,0.288256227758007,-2142
"MO","29135","Moniteau",1237,5344,0.187965354809299,-4107
"MO","29137","Monroe",853,3159,0.212612163509472,-2306
"MO","29139","Montgomery",1118,4124,0.213277375047692,-3006
"MO","29141","Morgan",1768,6757,0.207390029325513,-4989
"MO","29143","New Madrid",1933,5270,0.268360405386644,-3337
"MO","29145","Newton",4988,20546,0.19534737996397,-15558
"MO","29147","Nodaway",2529,6379,0.283902110462506,-3850
"MO","29149","Oregon",865,3668,0.190822854621663,-2803
"MO","29151","Osage",998,5845,0.145842466754348,-4847
"MO","29153","Ozark",724,3639,0.165940866376347,-2915
"MO","29155","Pemiscot",1946,3964,0.32927241962775,-2018
"MO","29157","Perry",1520,6907,0.180372611842886,-5387
"MO","29159","Pettis",4322,12792,0.252541778660746,-8470
"MO","29161","Phelps",4761,12699,0.272680412371134,-7938
"MO","29163","Pike",1806,5274,0.255084745762712,-3468
"MO","29165","Platte",18915,24975,0.430963773069036,-6060
"MO","29167","Polk",2630,10435,0.201301186375813,-7805
"MO","29169","Pulaski",2918,9870,0.228182671254301,-6952
"MO","29171","Putnam",352,1936,0.153846153846154,-1584
"MO","29173","Ralls",1138,3969,0.222831407871549,-2831
"MO","29175","Randolph",2283,7529,0.232674276396249,-5246
"MO","29177","Ray",3088,7103,0.303012461976254,-4015
"MO","29179","Reynolds",540,2402,0.183548606390211,-1862
"MO","29181","Ripley",830,4520,0.155140186915888,-3690
"MO","29183","St. Charles",68225,120899,0.360742158583786,-52674
"MO","29185","St. Clair",936,3501,0.210953346855984,-2565
"MO","29186","Ste. Genevieve",2540,5495,0.316116988176727,-2955
"MO","29187","St. Francois",6250,17467,0.263524054475693,-11217
"MO","29189","St. Louis County",280866,199081,0.585202116066982,81785
"MO","29195","Saline",2787,5977,0.318005476951164,-3190
"MO","29197","Schuyler",354,1505,0.190424959655729,-1151
"MO","29199","Scotland",365,1525,0.193121693121693,-1160
"MO","29201","Scott",3574,13168,0.213475092581531,-9594
"MO","29203","Shannon",776,2966,0.207375734901122,-2190
"MO","29205","Shelby",606,2524,0.193610223642173,-1918
"MO","29207","Stoddard",1873,11077,0.144633204633205,-9204
"MO","29209","Stone",2886,13149,0.179981290926099,-10263
"MO","29211","Sullivan",526,1884,0.218257261410788,-1358
"MO","29213","Taney",4367,18240,0.193170257000044,-13873
"MO","29215","Texas",1728,8875,0.162972743563143,-7147
"MO","29217","Vernon",1706,6526,0.207240038872692,-4820
"MO","29219","Warren",3915,11109,0.260583067092652,-7194
"MO","29221","Washington",1926,7047,0.214643931795386,-5121
"MO","29223","Wayne",946,4640,0.169351951306839,-3694
"MO","29225","Webster",3173,12829,0.198287714035746,-9656
"MO","29227","Worth",195,808,0.194416749750748,-613
"MO","29229","Wright",1166,6703,0.148176388359385,-5537
"MO","29510","St. Louis City",101487,20281,0.833445568622298,81206
"MS","28001","Adams",6921,5125,0.574547567657314,1796
"MS","28003","Alcorn",2684,11817,0.185090683401145,-9133
"MS","28005","Amite",2688,4282,0.385652797704448,-1594
"MS","28007","Attala",2847,4288,0.399018920812894,-1441
"MS","28009","Benton",1713,2240,0.433341765747534,-527
"MS","28011","Bolivar",8410,4251,0.664244530447832,4159
"MS","28013","Calhoun",1884,4360,0.301729660474055,-2476
"MS","28015","Carroll",1648,3774,0.303946883068978,-2126
"MS","28017","Chickasaw",3649,4127,0.469264403292181,-478
"MS","28019","Choctaw",1198,2763,0.302448876546327,-1565
"MS","28021","Claiborne",2523,414,0.859039836567926,2109
"MS","28023","Clarke",2556,5088,0.334379905808477,-2532
"MS","28025","Clay",5695,4136,0.579290001017191,1559
"MS","28027","Coahoma",6378,2426,0.724443434802363,3952
"MS","28029","Copiah",6203,5576,0.526615162577468,627
"MS","28031","Covington",3267,5423,0.375949367088608,-2156
"MS","28033","DeSoto",19892,42155,0.320595677470305,-22263
"MS","28035","Forrest",11271,15149,0.426608629825889,-3878
"MS","28037","Franklin",1471,2685,0.353946102021174,-1214
"MS","28039","George",1013,8652,0.104811174340404,-7639
"MS","28041","Greene",956,4309,0.181576448243115,-3353
"MS","28043","Grenada",4386,5940,0.424753050552005,-1554
"MS","28045","Hancock",3320,13720,0.194835680751174,-10400
"MS","28047","Harrison",20679,39710,0.342429912732451,-19031
"MS","28049","Hinds",64922,24919,0.722632205785777,40003
"MS","28051","Holmes",5820,1151,0.834887390618276,4669
"MS","28053","Humphreys",2652,924,0.741610738255034,1728
"MS","28055","Issaquena",395,298,0.56998556998557,97
"MS","28057","Itawamba",1100,8385,0.115972588297312,-7285
"MS","28059","Jackson",13087,31204,0.295477636540155,-18117
"MS","28061","Jasper",4367,4032,0.519942850339326,335
"MS","28063","Jefferson",3337,489,0.872190277051751,2848
"MS","28065","Jeff Davis",3720,2466,0.601357904946654,1254
"MS","28067","Jones",7748,20076,0.278464634847614,-12328
"MS","28069","Kemper",2827,1778,0.613897937024973,1049
"MS","28071","Lafayette",7968,10872,0.422929936305733,-2904
"MS","28073","Lamar",5044,18493,0.214300887963632,-13449
"MS","28075","Lauderdale",10910,17574,0.383022047465244,-6664
"MS","28077","Lawrence",2181,4072,0.34879257956181,-1891
"MS","28079","Leake",3579,4775,0.428417524539143,-1196
"MS","28081","Lee",9635,21695,0.307532716246409,-12060
"MS","28083","Leflore",6677,2757,0.707759168963324,3920
"MS","28085","Lincoln",4458,10550,0.29704157782516,-6092
"MS","28087","Lowndes",11545,13124,0.467996270623049,-1579
"MS","28089","Madison",18358,25607,0.417559422267713,-7249
"MS","28091","Marion",3572,7697,0.316975774247937,-4125
"MS","28093","Marshall",7944,6525,0.549035869790587,1419
"MS","28095","Monroe",5485,10107,0.351782965623397,-4622
"MS","28097","Montgomery",1775,2334,0.431978583596982,-559
"MS","28099","Neshoba",2668,7613,0.259507829977629,-4945
"MS","28101","Newton",2549,5929,0.30066053314461,-3380
"MS","28103","Noxubee",4330,1181,0.78570132462348,3149
"MS","28105","Oktibbeha",7851,7671,0.505798221878624,180
"MS","28107","Panola",7300,7371,0.497580260377616,-71
"MS","28109","Pearl River",2919,15530,0.158219957721286,-12611
"MS","28111","Perry",1220,4135,0.227824463118581,-2915
"MS","28113","Pike",7636,7748,0.496359854394176,-112
"MS","28115","Pontotoc",2123,9442,0.18357111975789,-7319
"MS","28117","Prentiss",2067,7647,0.21278567016677,-5580
"MS","28119","Quitman",2303,998,0.697667373523175,1305
"MS","28121","Rankin",13741,46168,0.229364536213257,-32427
"MS","28123","Scott",3999,5742,0.410532799507237,-1743
"MS","28125","Sharkey",1290,619,0.675746464117339,671
"MS","28127","Simpson",3871,7393,0.343661221590909,-3522
"MS","28129","Smith",1598,5877,0.213779264214047,-4279
"MS","28131","Stone",1400,4810,0.225442834138486,-3410
"MS","28133","Sunflower",6560,2768,0.703259005145798,3792
"MS","28135","Tallahatchie",3337,2462,0.57544404207622,875
"MS","28137","Tate",3804,7385,0.339976762892126,-3581
"MS","28139","Tippah",1808,7182,0.20111234705228,-5374
"MS","28141","Tishomingo",990,7117,0.122116689280868,-6127
"MS","28143","Tunica",2577,840,0.754170324846356,1737
"MS","28145","Union",1969,9161,0.176909254267745,-7192
"MS","28147","Walthall",2475,3374,0.423149256283125,-899
"MS","28149","Warren",8518,9420,0.4748578436838,-902
"MS","28151","Washington",9847,4541,0.684389769252155,5306
"MS","28153","Wayne",3493,5957,0.36962962962963,-2464
"MS","28155","Webster",1001,3949,0.202222222222222,-2948
"MS","28157","Wilkinson",2826,1305,0.684095860566449,1521
"MS","28159","Winston",3778,4874,0.43666204345816,-1096
"MS","28161","Yalobusha",2574,3366,0.433333333333333,-792
"MS","28163","Yazoo",5221,4568,0.533353764429462,653
"MT","30001","Beaverhead",1115,3243,0.255851307939422,-2128
"MT","30003","Big Horn",2061,1833,0.529275808936826,228
"MT","30005","Blaine",1187,1259,0.48528209321341,-72
"MT","30007","Broadwater",566,2329,0.195509499136442,-1763
"MT","30009","Carbon",1824,3729,0.328471096704484,-1905
"MT","30011","Carter",70,677,0.0937081659973226,-607
"MT","30013","Cascade",12053,19343,0.383902407950057,-7290
"MT","30015","Chouteau",729,1676,0.303118503118503,-947
"MT","30017","Custer",1172,3638,0.243659043659044,-2466
"MT","30019","Daniels",167,729,0.186383928571429,-562
"MT","30021","Dawson",786,3298,0.192458374142997,-2512
"MT","30023","Deer Lodge",2018,1736,0.537559936068194,282
"MT","30025","Fallon",154,1276,0.107692307692308,-1122
"MT","30027","Fergus",1196,4235,0.22021727122077,-3039
"MT","30029","Flathead",13233,30079,0.305527336534909,-16846
"MT","30031","Gallatin",23879,23360,0.505493342365418,519
"MT","30033","Garfield",34,653,0.049490538573508,-619
"MT","30035","Glacier",3076,1598,0.658108686350021,1478
"MT","30037","Golden Valley",71,365,0.162844036697248,-294
"MT","30039","Granite",469,1185,0.283555018137848,-716
"MT","30041","Hill",2350,3446,0.405452035886818,-1096
"MT","30043","Jefferson",1975,4099,0.325156404346394,-2124
"MT","30045","Judith Basin",232,867,0.211101000909918,-635
"MT","30047","Lake",4703,7453,0.386887133925633,-2750
"MT","30049","Lewis and Clark",14331,16665,0.462349980642664,-2334
"MT","30051","Liberty",205,695,0.227777777777778,-490
"MT","30053","Lincoln",2040,6720,0.232876712328767,-4680
"MT","30055","McCone",154,858,0.152173913043478,-704
"MT","30057","Madison",1175,3280,0.26374859708193,-2105
"MT","30059","Meagher",191,728,0.207834602829162,-537
"MT","30061","Mineral",515,1322,0.280348394120849,-807
"MT","30063","Missoula",30740,21699,0.586204923816244,9041
"MT","30065","Musselshell",331,1961,0.144415357766143,-1630
"MT","30067","Park",3521,4872,0.419516263552961,-1351
"MT","30069","Petroleum",30,276,0.0980392156862745,-246
"MT","30071","Phillips",315,1715,0.155172413793103,-1400
"MT","30073","Pondera",737,1786,0.292112564407451,-1049
"MT","30075","Powder River",127,880,0.126117179741807,-753
"MT","30077","Powell",549,2017,0.213951675759938,-1468
"MT","30079","Prairie",100,555,0.152671755725191,-455
"MT","30081","Ravalli",6166,14673,0.295887518594942,-8507
"MT","30083","Richland",669,3885,0.146903820816864,-3216
"MT","30085","Roosevelt",1504,1722,0.466212027278363,-218
"MT","30087","Rosebud",969,2211,0.304716981132075,-1242
"MT","30089","Sanders",1211,4268,0.221025734623106,-3057
"MT","30091","Sheridan",476,1237,0.277875072971395,-761
"MT","30093","Silver Bow",8545,6252,0.577481922011219,2293
"MT","30095","Stillwater",904,3630,0.199382443758271,-2726
"MT","30097","Sweet Grass",398,1580,0.201213346814965,-1182
"MT","30099","Teton",803,2152,0.271742808798646,-1349
"MT","30101","Toole",399,1495,0.210665258711721,-1096
"MT","30103","Treasure",59,350,0.144254278728606,-291
"MT","30105","Valley",886,2697,0.247278816634106,-1811
"MT","30107","Wheatland",179,698,0.204104903078677,-519
"MT","30109","Wibaux",55,460,0.106796116504854,-405
"MT","30111","Yellowstone",21117,38675,0.353174337704041,-17558
"NC","37001","Alamance",29268,38235,0.433580729745345,-8967
"NC","37003","Alexander",3750,13826,0.21335912608102,-10076
"NC","37005","Alleghany",1300,3789,0.255452937708784,-2489
"NC","37007","Anson",5785,4480,0.563565513882124,1305
"NC","37009","Ashe",3476,9353,0.270948632005612,-5877
"NC","37011","Avery",1670,6226,0.211499493414387,-4556
"NC","37013","Beaufort",8699,14478,0.37532898994693,-5779
"NC","37015","Bertie",5837,3476,0.626758294856652,2361
"NC","37017","Bladen",7021,8511,0.452034509399948,-1490
"NC","37019","Brunswick",23117,42440,0.352624433698918,-19323
"NC","37021","Buncombe",74937,55339,0.575217231109337,19598
"NC","37023","Burke",10930,25741,0.298055684328216,-14811
"NC","37025","Cabarrus",35048,53224,0.397045495740439,-18176
"NC","37027","Caldwell",8403,26499,0.240759841842874,-18096
"NC","37029","Camden",1266,3527,0.264135197162529,-2261
"NC","37031","Carteret",9806,26228,0.272131875450963,-16422
"NC","37033","Caswell",4549,5758,0.441350538469002,-1209
"NC","37035","Catawba",21050,48062,0.304578076166223,-27012
"NC","37037","Chatham",20953,17012,0.55190306861583,3941
"NC","37039","Cherokee",2809,10711,0.207766272189349,-7902
"NC","37041","Chowan",2965,3983,0.426741508347726,-1018
"NC","37043","Clay",1352,4395,0.235253175569863,-3043
"NC","37045","Cleveland",14896,28394,0.344097944097944,-13498
"NC","37047","Columbus",8991,14177,0.388078383977901,-5186
"NC","37049","Craven",17481,27556,0.388147523147634,-10075
"NC","37051","Cumberland",70523,50593,0.582276495260742,19930
"NC","37053","Currituck",2879,9070,0.240940664490752,-6191
"NC","37055","Dare",7079,11283,0.385524452674001,-4204
"NC","37057","Davidson",17328,52870,0.246844639448417,-35542
"NC","37059","Davie",5228,15502,0.252194886637723,-10274
"NC","37061","Duplin",8196,12151,0.40281122524205,-3955
"NC","37063","Durham",118783,27879,0.809909860768297,90904
"NC","37065","Edgecombe",16152,8219,0.662754913626852,7933
"NC","37067","Forsyth",92488,74793,0.552890047285705,17695
"NC","37069","Franklin",12811,16320,0.439772064124129,-3509
"NC","37071","Gaston",30982,61467,0.335125312334368,-30485
"NC","37073","Gates",2371,2851,0.454040597472233,-480
"NC","37075","Graham",761,3260,0.189256403879632,-2499
"NC","37077","Granville",12827,13500,0.487218444942455,-673
"NC","37079","Greene",3570,4358,0.450302724520686,-788
"NC","37081","Guilford",147949,97461,0.602864593944827,50488
"NC","37083","Halifax",15642,8954,0.635957066189624,6688
"NC","37085","Harnett",16452,27278,0.37621769951978,-10826
"NC","37087","Haywood",10414,18844,0.355936837787955,-8430
"NC","37089","Henderson",19664,35535,0.356238337651044,-15871
"NC","37091","Hertford",6886,3081,0.690879903682151,3805
"NC","37093","Hoke",9608,7676,0.555889840314742,1932
"NC","37095","Hyde",956,1275,0.428507395786643,-319
"NC","37097","Iredell",24441,54164,0.310934418930093,-29723
"NC","37099","Jackson",7564,9706,0.437984944991314,-2142
"NC","37101","Johnston",28153,54082,0.342348148598529,-25929
"NC","37103","Jones",2041,2941,0.409674829385789,-900
"NC","37105","Lee",10380,13625,0.432409914601125,-3245
"NC","37107","Lenoir",11752,13354,0.468095276029634,-1602
"NC","37109","Lincoln",9836,28653,0.25555353477617,-18817
"NC","37111","McDowell",4645,14517,0.242406846884459,-9872
"NC","37113","Macon",4841,12035,0.286857075136288,-7194
"NC","37115","Madison",3899,6735,0.36665412826782,-2836
"NC","37117","Martin",5814,5874,0.497433264887064,-60
"NC","37119","Mecklenburg",292258,154303,0.654463779864341,137955
"NC","37121","Mitchell",1585,6225,0.202944942381562,-4640
"NC","37123","Montgomery",4108,7070,0.36750760422258,-2962
"NC","37125","Moore",16148,30273,0.347859804829711,-14125
"NC","37127","Nash",23024,23142,0.498722003205822,-118
"NC","37129","New Hanover",50219,54665,0.478805156172533,-4446
"NC","37131","Northampton",6113,3556,0.632226703899059,2557
"NC","37133","Onslow",17156,36342,0.320684885416277,-19186
"NC","37135","Orange",59105,18373,0.762861715583779,40732
"NC","37137","Pamlico",2427,4225,0.364852675886951,-1798
"NC","37139","Pasquotank",8455,8082,0.511277740823608,373
"NC","37141","Pender",9086,17317,0.344127561261978,-8231
"NC","37143","Perquimans",2291,4143,0.356077090456947,-1852
"NC","37145","Person",7772,11116,0.41147818720881,-3344
"NC","37147","Pitt",40967,35191,0.537921163896111,5776
"NC","37149","Polk",3715,6738,0.355400363532,-3023
"NC","37151","Randolph",13074,49156,0.210091595693395,-36082
"NC","37153","Richmond",8290,10199,0.448374709286603,-1909
"NC","37155","Robeson",18377,20294,0.475213984639652,-1917
"NC","37157","Rockingham",14057,26463,0.346915103652517,-12406
"NC","37159","Rowan",19208,42388,0.311838431066952,-23180
"NC","37161","Rutherford",7451,21694,0.255652770629611,-14243
"NC","37163","Sampson",10486,14761,0.415336475620866,-4275
"NC","37165","Scotland",7279,6212,0.539544881773034,1067
"NC","37167","Stanly",7008,21788,0.243367134324212,-14780
"NC","37169","Stokes",4645,16976,0.214837426576014,-12331
"NC","37171","Surry",7438,23495,0.240455177318721,-16057
"NC","37173","Swain",2186,3557,0.380637297579662,-1371
"NC","37175","Transylvania",6520,10441,0.384411296503744,-3921
"NC","37177","Tyrrell",705,968,0.421398684997011,-263
"NC","37179","Union",34051,66265,0.339437377885881,-32214
"NC","37181","Vance",12168,7304,0.624897288414133,4864
"NC","37183","Wake",298353,193607,0.606457842100984,104746
"NC","37185","Warren",6668,3302,0.668806419257773,3366
"NC","37187","Washington",3490,2560,0.576859504132231,930
"NC","37189","Watauga",13953,13521,0.507861978597947,432
"NC","37191","Wayne",21520,27360,0.440261865793781,-5840
"NC","37193","Wilkes",6596,23613,0.218345526167698,-17017
"NC","37195","Wilson",19527,17410,0.528656902293094,2117
"NC","37197","Yadkin",3140,13815,0.185196107342967,-10675
"NC","37199","Yancey",3181,6367,0.333158776707164,-3186
"ND","38001","Adams",216,904,0.192857142857143,-688
"ND","38003","Barnes",1597,3156,0.335998316852514,-1559
"ND","38005","Benson",842,927,0.475975127190503,-85
"ND","38007","Billings",58,492,0.105454545454545,-434
"ND","38009","Bottineau",734,2482,0.228233830845771,-1748
"ND","38011","Bowman",227,1445,0.135765550239234,-1218
"ND","38013","Burke",118,879,0.118355065195587,-761
"ND","38015","Burleigh",10865,32499,0.250553454478369,-21634
"ND","38017","Cass",31291,39738,0.440538371651016,-8447
"ND","38019","Cavalier",476,1356,0.259825327510917,-880
"ND","38021","Dickey",551,1656,0.249660172179429,-1105
"ND","38023","Divide",243,860,0.220308250226655,-617
"ND","38025","Dunn",356,1753,0.168800379326695,-1397
"ND","38027","Eddy",354,790,0.309440559440559,-436
"ND","38029","Emmons",215,1672,0.113937466878643,-1457
"ND","38031","Foster",346,1237,0.218572331017056,-891
"ND","38033","Golden Valley",99,793,0.110986547085202,-694
"ND","38035","Grand Forks",10828,16325,0.398777299009318,-5497
"ND","38037","Grant",187,1098,0.145525291828794,-911
"ND","38039","Griggs",298,847,0.260262008733624,-549
"ND","38041","Hettinger",168,1032,0.14,-864
"ND","38043","Kidder",179,1106,0.139299610894942,-927
"ND","38045","LaMoure",500,1475,0.253164556962025,-975
"ND","38047","Logan",112,867,0.114402451481103,-755
"ND","38049","McHenry",474,1991,0.192292089249493,-1517
"ND","38051","McIntosh",233,1095,0.175451807228916,-862
"ND","38053","McKenzie",696,3661,0.159742942391554,-2965
"ND","38055","McLean",1070,3827,0.218501123136614,-2757
"ND","38057","Mercer",616,3715,0.142230431770954,-3099
"ND","38059","Morton",3077,11319,0.21373992775771,-8242
"ND","38061","Mountrail",1211,2551,0.321903242955875,-1340
"ND","38063","Nelson",536,1025,0.343369634849455,-489
"ND","38065","Oliver",119,827,0.125792811839323,-708
"ND","38067","Pembina",681,2204,0.236048526863085,-1523
"ND","38069","Pierce",431,1433,0.231223175965665,-1002
"ND","38071","Ramsey",1505,3216,0.318788392289769,-1711
"ND","38073","Ransom",836,1209,0.40880195599022,-373
"ND","38075","Renville",200,978,0.169779286926995,-778
"ND","38077","Richland",2064,4759,0.302506228931555,-2695
"ND","38079","Rolette",2097,1210,0.634109464771696,887
"ND","38081","Sargent",693,1088,0.389107243121842,-395
"ND","38083","Sheridan",94,644,0.127371273712737,-550
"ND","38085","Sioux",758,256,0.747534516765286,502
"ND","38087","Slope",42,361,0.104218362282878,-319
"ND","38089","Stark",1745,9718,0.152228910407398,-7973
"ND","38091","Steele",361,537,0.402004454342984,-176
"ND","38093","Stutsman",2484,6706,0.270293797606094,-4222
"ND","38095","Towner",305,733,0.29383429672447,-428
"ND","38097","Traill",1239,2263,0.353797829811536,-1024
"ND","38099","Walsh",1166,2991,0.280490738513351,-1825
"ND","38101","Ward",5792,18601,0.237445168695937,-12809
"ND","38103","Wells",419,1793,0.189421338155515,-1374
"ND","38105","Williams",1722,10033,0.146490854955338,-8311
"NE","31001","Adams",3272,9205,0.262242526248297,-5933
"NE","31003","Antelope",381,2717,0.122982569399613,-2336
"NE","31005","Arthur",16,237,0.0632411067193676,-221
"NE","31007","Banner",18,355,0.0482573726541555,-337
"NE","31009","Blaine",30,273,0.099009900990099,-243
"NE","31011","Boone",414,2299,0.152598599336528,-1885
"NE","31013","Box Butte",953,3550,0.211636686653342,-2597
"NE","31015","Boyd",128,978,0.115732368896926,-850
"NE","31017","Brown",153,1380,0.0998043052837573,-1227
"NE","31019","Buffalo",4690,14424,0.245369885947473,-9734
"NE","31021","Burt",928,2360,0.282238442822384,-1432
"NE","31023","Butler",690,3068,0.183608302288451,-2378
"NE","31025","Cass",3461,8388,0.292092159675922,-4927
"NE","31027","Cedar",572,3533,0.139342265529842,-2961
"NE","31029","Chase",171,1621,0.0954241071428571,-1450
"NE","31031","Cherry",317,2623,0.107823129251701,-2306
"NE","31033","Cheyenne",702,3610,0.162801484230056,-2908
"NE","31035","Clay",470,2373,0.165318325712276,-1903
"NE","31037","Colfax",857,2171,0.283025099075297,-1314
"NE","31039","Cuming",712,3095,0.18702390333596,-2383
"NE","31041","Custer",635,4616,0.120929346791087,-3981
"NE","31043","Dakota",2904,4028,0.418926716676284,-1124
"NE","31045","Dawes",785,2559,0.234748803827751,-1774
"NE","31047","Dawson",2116,5935,0.262824493851695,-3819
"NE","31049","Deuel",120,809,0.129171151776103,-689
"NE","31051","Dixon",556,2041,0.214093184443589,-1485
"NE","31053","Dodge",4451,9736,0.313737929090012,-5285
"NE","31055","Douglas",105207,102151,0.507368898233972,3056
"NE","31057","Dundy",89,823,0.0975877192982456,-734
"NE","31059","Fillmore",610,2100,0.225092250922509,-1490
"NE","31061","Franklin",250,1345,0.156739811912226,-1095
"NE","31063","Frontier",161,1106,0.12707182320442,-945
"NE","31065","Furnas",304,1915,0.136998648039658,-1611
"NE","31067","Gage",2930,6333,0.316312209867214,-3403
"NE","31069","Garden",153,869,0.149706457925636,-716
"NE","31071","Garfield",121,819,0.128723404255319,-698
"NE","31073","Gosper",165,792,0.172413793103448,-627
"NE","31075","Grant",20,367,0.0516795865633075,-347
"NE","31077","Greeley",210,911,0.187332738626227,-701
"NE","31079","Hall",6142,14139,0.302845027365514,-7997
"NE","31081","Hamilton",873,3763,0.188308886971527,-2890
"NE","31083","Harlan",219,1302,0.143984220907298,-1083
"NE","31085","Hayes",30,471,0.0598802395209581,-441
"NE","31087","Hitchcock",158,1216,0.114992721979622,-1058
"NE","31089","Holt",522,4275,0.108818011257036,-3753
"NE","31091","Hooker",40,355,0.10126582278481,-315
"NE","31093","Howard",544,2284,0.192362093352192,-1740
"NE","31095","Jefferson",831,2387,0.258234928527035,-1556
"NE","31097","Johnson",560,1348,0.293501048218029,-788
"NE","31099","Kearney",550,2519,0.17921146953405,-1969
"NE","31101","Keith",560,3203,0.148817432899282,-2643
"NE","31103","Keya Paha",39,458,0.0784708249496982,-419
"NE","31105","Kimball",227,1317,0.147020725388601,-1090
"NE","31107","Knox",715,3181,0.183521560574949,-2466
"NE","31109","Lancaster",60533,60456,0.500318210746431,77
"NE","31111","Lincoln",2878,11992,0.193544048419637,-9114
"NE","31113","Logan",32,400,0.0740740740740741,-368
"NE","31115","Loup",48,323,0.129380053908356,-275
"NE","31117","McPherson",14,257,0.0516605166051661,-243
"NE","31119","Madison",2663,10518,0.202033229648737,-7855
"NE","31121","Merrick",601,2914,0.170981507823613,-2313
"NE","31123","Morrill",282,1788,0.136231884057971,-1506
"NE","31125","Nance",280,1257,0.182173064411191,-977
"NE","31127","Nemaha",765,2068,0.270031768443346,-1303
"NE","31129","Nuckolls",348,1709,0.16917841516772,-1361
"NE","31131","Otoe",2017,4833,0.294452554744526,-2816
"NE","31133","Pawnee",279,970,0.22337870296237,-691
"NE","31135","Perkins",160,1202,0.117474302496329,-1042
"NE","31137","Phelps",571,3832,0.129684306154894,-3261
"NE","31139","Pierce",382,3052,0.111240535818288,-2670
"NE","31141","Platte",2612,10864,0.193826061145741,-8252
"NE","31143","Polk",411,2019,0.169135802469136,-1608
"NE","31145","Red Willow",638,4212,0.131546391752577,-3574
"NE","31147","Richardson",798,2684,0.229178632969558,-1886
"NE","31149","Rock",70,687,0.0924702774108322,-617
"NE","31151","Saline",1630,2849,0.363920517972762,-1219
"NE","31153","Sarpy",27704,44649,0.382900501706909,-16945
"NE","31155","Saunders",2509,7486,0.251025512756378,-4977
"NE","31157","Scotts Bluff",3151,9952,0.240479279554301,-6801
"NE","31159","Seward",1881,5451,0.256546644844517,-3570
"NE","31161","Sheridan",286,2192,0.115415657788539,-1906
"NE","31163","Sherman",338,1143,0.228224172856178,-805
"NE","31165","Sioux",77,602,0.11340206185567,-525
"NE","31167","Stanton",417,2173,0.161003861003861,-1756
"NE","31169","Thayer",490,1993,0.197341925090616,-1503
"NE","31171","Thomas",30,344,0.0802139037433155,-314
"NE","31173","Thurston",911,1013,0.473492723492723,-102
"NE","31175","Valley",337,1770,0.159943046986236,-1433
"NE","31177","Washington",2606,7374,0.261122244488978,-4768
"NE","31179","Wayne",828,2675,0.236368826719954,-1847
"NE","31181","Webster",306,1320,0.188191881918819,-1014
"NE","31183","Wheeler",62,377,0.14123006833713,-315
"NE","31185","York",1181,4686,0.201295380944265,-3505
"NH","33001","Belknap",13517,19315,0.411701998050682,-5798
"NH","33003","Carroll",12987,14635,0.47016870610383,-1648
"NH","33005","Cheshire",22064,16876,0.566615305598356,5188
"NH","33007","Coos",6558,7951,0.451995313253842,-1393
"NH","33009","Grafton",28510,19010,0.599957912457912,9500
"NH","33011","Hillsborough",99589,100013,0.498937886393924,-424
"NH","33013","Merrimack",40198,37674,0.516206081775221,2524
"NH","33015","Rockingham",79994,90447,0.469335429855493,-10453
"NH","33017","Strafford",34894,29072,0.545508551417941,5822
"NH","33019","Sullivan",10210,10796,0.486051604303532,-586
"NJ","34001","Atlantic",54472,47882,0.532192195712918,6590
"NJ","34003","Bergen",209251,163220,0.561791387785895,46031
"NJ","34005","Burlington",108361,79539,0.576695050558808,28822
"NJ","34007","Camden",142375,71020,0.667189952904239,71355
"NJ","34009","Cape May",18626,28237,0.397456415509037,-9611
"NJ","34011","Cumberland",27045,24213,0.527624956104413,2832
"NJ","34013","Essex",231031,62059,0.788259578968917,168972
"NJ","34015","Gloucester",66355,66949,0.497772009842165,-594
"NJ","34017","Hudson",149980,45615,0.766788517088883,104365
"NJ","34019","Hunterdon",28797,38565,0.427496214482943,-9768
"NJ","34021","Mercer",93721,42604,0.687482119933981,51117
"NJ","34023","Middlesex",164887,108981,0.602067419340704,55906
"NJ","34025","Monmouth",135825,165305,0.451051041078604,-29480
"NJ","34027","Morris",114437,125376,0.477192645936626,-10939
"NJ","34029","Ocean",81845,170103,0.324848778319336,-88258
"NJ","34031","Passaic",112608,71488,0.611680862158874,41120
"NJ","34033","Salem",11766,16256,0.419884376561273,-4490
"NJ","34035","Somerset",83839,64640,0.564652240384162,19199
"NJ","34037","Sussex",24132,46486,0.341725905576482,-22354
"NJ","34039","Union",145412,67582,0.682704677127055,77830
"NJ","34041","Warren",16991,29393,0.366311659192825,-12402
"NM","35001","Bernalillo",141960,93874,0.601948828413206,48086
"NM","35003","Catron",426,1453,0.226716338477914,-1027
"NM","35005","Chaves",5530,12869,0.300559813033317,-7339
"NM","35006","Cibola",3721,3179,0.539275362318841,542
"NM","35007","Colfax",2118,2569,0.45188820140815,-451
"NM","35009","Curry",2776,7560,0.268575851393189,-4784
"NM","35011","DeBaca",192,617,0.237330037082818,-425
"NM","35013","Dona Ana",37543,25095,0.599364602956672,12448
"NM","35015","Eddy",5008,13124,0.276196779174939,-8116
"NM","35017","Grant",6226,5251,0.542476256861549,975
"NM","35019","Guadalupe",962,591,0.619446233097231,371
"NM","35021","Harding",156,311,0.334047109207709,-155
"NM","35023","Hidalgo",780,906,0.462633451957295,-126
"NM","35025","Lea",3877,12306,0.239572390780449,-8429
"NM","35027","Lincoln",2329,5889,0.283402287661231,-3560
"NM","35028","Los Alamos",5443,3329,0.620497036023712,2114
"NM","35029","Luna",3195,3478,0.478795144612618,-283
"NM","35031","McKinley",13162,4893,0.72899473829964,8269
"NM","35033","Mora",1533,662,0.698405466970387,871
"NM","35035","Otero",6033,11756,0.339142166507392,-5723
"NM","35037","Quay",1016,2208,0.315136476426799,-1192
"NM","35039","Rio Arriba",9534,3583,0.726843028131433,5951
"NM","35041","Roosevelt",1445,3865,0.272128060263653,-2420
"NM","35043","Sandoval",27405,25748,0.515587078810227,1657
"NM","35045","San Juan",12826,27879,0.315096425500553,-15053
"NM","35047","San Miguel",7249,2302,0.75897811747461,4947
"NM","35049","Santa Fe",49956,14198,0.778688780122829,35758
"NM","35051","Sierra",1600,2998,0.347977381470204,-1398
"NM","35053","Socorro",3275,2592,0.55820692006136,683
"NM","35055","Taos",10550,2706,0.795866022933011,7844
"NM","35057","Torrance",1770,3695,0.32387923147301,-1925
"NM","35059","Union",318,1214,0.20757180156658,-896
"NM","35061","Valencia",10810,13175,0.450698353137378,-2365
"NV","32001","Churchill",2210,7828,0.220163379159195,-5618
"NV","32003","Clark",401068,319571,0.556544955241112,81497
"NV","32005","Douglas",8453,17406,0.326888124057388,-8953
"NV","32007","Elko",3400,13542,0.200684688938732,-10142
"NV","32009","Esmeralda",65,329,0.16497461928934,-264
"NV","32011","Eureka",74,723,0.0928481806775408,-649
"NV","32013","Humboldt",1386,4521,0.23463687150838,-3135
"NV","32015","Lander",403,1828,0.180636485880771,-1425
"NV","32017","Lincoln",285,1671,0.145705521472393,-1386
"NV","32019","Lyon",6146,16005,0.277459256918424,-9859
"NV","32021","Mineral",637,1179,0.350770925110132,-542
"NV","32023","Nye",5095,13320,0.276676622318762,-8225
"NV","32027","Pershing",430,1403,0.234588106928532,-973
"NV","32029","Storey",752,1616,0.317567567567568,-864
"NV","32031","Washoe",97032,94529,0.506533166980753,2503
"NV","32033","White Pine",707,2723,0.206122448979592,-2016
"NV","32510","Carson City",9610,13125,0.42269628326369,-3515
"NY","36001","Albany",74775,44227,0.628350784020437,30548
"NY","36003","Allegany",4473,11712,0.276367006487488,-7239
"NY","36005","Bronx",318403,34424,0.902433770658141,283979
"NY","36007","Broome",35212,38077,0.480454092701497,-2865
"NY","36009","Cattaraugus",8717,18668,0.318312945042907,-9951
"NY","36011","Cayuga",12202,16194,0.42970840963516,-3992
"NY","36013","Chautauqua",17281,29418,0.370050750551404,-12137
"NY","36015","Chemung",12394,19025,0.394474680925555,-6631
"NY","36017","Chenango",5943,11024,0.350268167619497,-5081
"NY","36019","Clinton",13446,13181,0.504976152026139,265
"NY","36021","Columbia",13123,12756,0.507090691294099,367
"NY","36023","Cortland",7976,9207,0.464179712506547,-1231
"NY","36025","Delaware",5825,11012,0.34596424541189,-5187
"NY","36027","Dutchess",56874,58163,0.494397454731956,-1289
"NY","36029","Erie",192065,173817,0.524937001546947,18248
"NY","36031","Essex",6760,7275,0.481653010331315,-515
"NY","36033","Franklin",6517,7636,0.460467745354342,-1119
"NY","36035","Fulton",5805,12759,0.312702003878474,-6954
"NY","36037","Genesee",6946,15986,0.302895517181231,-9040
"NY","36039","Greene",6370,11546,0.355548113418174,-5176
"NY","36041","Hamilton",752,1795,0.295249312917157,-1043
"NY","36043","Herkimer",7289,15664,0.317561974469568,-8375
"NY","36045","Jefferson",12289,19947,0.381219754311949,-7658
"NY","36047","Brooklyn",595086,133653,0.816596888597975,461433
"NY","36049","Lewis",2828,6916,0.290229885057471,-4088
"NY","36051","Livingston",10478,19211,0.352925325878271,-8733
"NY","36053","Madison",10548,14901,0.41447601084522,-4353
"NY","36055","Monroe",174063,128871,0.574590504862445,45192
"NY","36057","Montgomery",5961,10579,0.360399032648126,-4618
"NY","36059","Nassau",307326,275479,0.527322174655331,31847
"NY","36061","Manhattan",515481,58935,0.897400142057324,456546
"NY","36063","Niagara",32888,49223,0.400530988539903,-16335
"NY","36065","Oneida",30749,48490,0.388053862365754,-17741
"NY","36067","Onondaga",102915,78277,0.567988652920659,24638
"NY","36069","Ontario",20233,24343,0.45389895908112,-4110
"NY","36071","Orange",63037,72129,0.466367281712857,-9092
"NY","36073","Orleans",4327,11582,0.271984411339493,-7255
"NY","36075","Oswego",15614,25870,0.376386076559637,-10256
"NY","36077","Otsego",9285,12284,0.430478928091242,-2999
"NY","36079","Putnam",17363,25241,0.407543892592245,-7878
"NY","36081","Queens",473389,138550,0.773588543956179,334839
"NY","36083","Rensselaer",30039,31933,0.484718905312076,-1894
"NY","36085","Staten Island",67561,95612,0.414045215813891,-28051
"NY","36087","Rockland",63454,57148,0.526143845044029,6306
"NY","36089","Saint Lawrence",14659,18450,0.442749705518137,-3791
"NY","36091","Saratoga",46546,51088,0.476739660364217,-4542
"NY","36093","Schenectady",30870,27268,0.53097801781967,3602
"NY","36095","Schoharie",3777,8173,0.316066945606695,-4396
"NY","36097","Schuyler",2761,5179,0.347732997481108,-2418
"NY","36099","Seneca",5175,6719,0.435093324365226,-1544
"NY","36101","Steuben",11215,25091,0.308902109844103,-13876
"NY","36103","Suffolk",276953,328403,0.457504344550975,-51450
"NY","36105","Sullivan",10983,14626,0.428872661954782,-3643
"NY","36107","Tioga",6852,12528,0.353560371517028,-5676
"NY","36109","Tompkins",25555,9647,0.725953070848247,15908
"NY","36111","Ulster",40010,32962,0.548292495751795,7048
"NY","36113","Warren",11366,14284,0.443118908382066,-2918
"NY","36115","Washington",8238,12770,0.392136329017517,-4532
"NY","36117","Wayne",12378,21935,0.360737912744441,-9557
"NY","36119","Westchester",245670,121643,0.668830125805512,124027
"NY","36121","Wyoming",3585,11884,0.231753830241127,-8299
"NY","36123","Yates",3219,5180,0.383259911894273,-1961
"OH","39001","Adams",2293,8445,0.213540696591544,-6152
"OH","39003","Allen",12815,29858,0.300306985681813,-17043
"OH","39005","Ashland",5659,17169,0.247897319081829,-11510
"OH","39007","Ashtabula",15191,22755,0.400332050809044,-7564
"OH","39009","Athens",15552,10816,0.589805825242718,4736
"OH","39011","Auglaize",3825,18130,0.174219995445229,-14305
"OH","39013","Belmont",8652,20729,0.294476021918927,-12077
"OH","39015","Brown",4270,14257,0.230474442705241,-9987
"OH","39017","Butler",56700,104441,0.351865757318125,-47741
"OH","39019","Carroll",3124,9067,0.256254614059552,-5943
"OH","39021","Champaign",4488,12314,0.267111058207356,-7826
"OH","39023","Clark",22666,34311,0.397809642487319,-11645
"OH","39025","Clermont",26096,65960,0.2834796211002,-39864
"OH","39027","Clinton",3943,13466,0.226492044344879,-9523
"OH","39029","Columbiana",12273,31086,0.283055421019857,-18813
"OH","39031","Coshocton",3908,10381,0.273497095667996,-6473
"OH","39033","Crawford",4518,13265,0.254062869032222,-8747
"OH","39035","Cuyahoga",383974,179894,0.680964339171579,204080
"OH","39037","Darke",4395,19698,0.182418129747229,-15303
"OH","39039","Defiance",5282,11478,0.315155131264916,-6196
"OH","39041","Delaware",39584,55660,0.41560623241359,-16076
"OH","39043","Erie",15692,19301,0.448432543651587,-3609
"OH","39045","Fairfield",24150,43163,0.358771708288146,-19013
"OH","39047","Fayette",2672,7763,0.256061332055582,-5091
"OH","39049","Franklin",335961,192328,0.635941691006248,143633
"OH","39051","Fulton",5981,13419,0.308298969072165,-7438
"OH","39053","Gallia",2564,9567,0.21135932734317,-7003
"OH","39055","Geauga",17165,29577,0.367228616661675,-12412
"OH","39057","Greene",28023,47506,0.371023050748719,-19483
"OH","39059","Guernsey",4286,11164,0.277411003236246,-6878
"OH","39061","Hamilton",207587,169972,0.549813406646378,37615
"OH","39063","Hancock",9419,23777,0.283739004699361,-14358
"OH","39065","Hardin",2870,8541,0.251511699237578,-5671
"OH","39067","Harrison",1663,5021,0.248803111909037,-3358
"OH","39069","Henry",3690,9136,0.287696865741463,-5446
"OH","39071","Highland",3436,13005,0.208989720819901,-9569
"OH","39073","Hocking",3713,8282,0.309545644018341,-4569
"OH","39075","Holmes",1766,8578,0.170726991492653,-6812
"OH","39077","Huron",7080,15930,0.307692307692308,-8850
"OH","39079","Jackson",3142,9618,0.246238244514107,-6476
"OH","39081","Jefferson",9483,20668,0.31451693144506,-11185
"OH","39083","Knox",7959,18563,0.300090490913204,-10604
"OH","39085","Lake",45056,62627,0.418413305721423,-17571
"OH","39087","Lawrence",6849,18240,0.272988162142772,-11391
"OH","39089","Licking",26360,49346,0.348189047103268,-22986
"OH","39091","Logan",4537,15586,0.22546340008945,-11049
"OH","39093","Lorain",64958,65346,0.498511173870334,-388
"OH","39095","Lucas",107363,74102,0.591645771911939,33261
"OH","39097","Madison",4662,11319,0.291721419185283,-6657
"OH","39099","Mahoning",56188,52808,0.515505156152519,3380
"OH","39101","Marion",7748,16563,0.318703467566122,-8815
"OH","39103","Medina",31582,53811,0.369842961366857,-22229
"OH","39105","Meigs",2157,6869,0.23897629071571,-4712
"OH","39107","Mercer",3335,17200,0.162405648892135,-13865
"OH","39109","Miami",12832,36311,0.261115520013023,-23479
"OH","39111","Monroe",1647,4781,0.25622277535781,-3134
"OH","39113","Montgomery",117661,120766,0.493488573022351,-3105
"OH","39115","Morgan",1711,4315,0.283936276136741,-2604
"OH","39117","Morrow",3711,11722,0.240458757208579,-8011
"OH","39119","Muskingum",10926,23588,0.316567190125746,-12662
"OH","39121","Noble",1201,4441,0.212867777383906,-3240
"OH","39123","Ottawa",8136,12389,0.396394640682095,-4253
"OH","39125","Paulding",2068,6359,0.245401685059926,-4291
"OH","39127","Perry",4072,9978,0.289822064056939,-5906
"OH","39129","Pickaway",6325,16482,0.27732713640549,-10157
"OH","39131","Pike",3443,7669,0.309845212383009,-4226
"OH","39133","Portage",31463,38978,0.446657486407064,-7515
"OH","39135","Preble",4323,15376,0.2194527640997,-11053
"OH","39137","Putnam",2874,14704,0.16349982933212,-11830
"OH","39139","Richland",15629,35805,0.303865147567757,-20176
"OH","39141","Ross",9905,17833,0.357091354820102,-7928
"OH","39143","Sandusky",9733,16045,0.377570020948095,-6312
"OH","39145","Scioto",8841,19742,0.309309729559528,-10901
"OH","39147","Seneca",7237,14559,0.332033400623968,-7322
"OH","39149","Shelby",4143,18148,0.185859764030326,-14005
"OH","39151","Stark",66581,96345,0.408657918318746,-29764
"OH","39153","Summit",129922,109531,0.542578293026189,20391
"OH","39155","Trumbull",42130,48152,0.466648944418599,-6022
"OH","39157","Tuscarawas",11895,26105,0.313026315789474,-14210
"OH","39159","Union",7530,17601,0.299629939119016,-10071
"OH","39161","Van Wert",2667,10328,0.205232781839169,-7661
"OH","39163","Vinton",1332,3799,0.25959851880725,-2467
"OH","39165","Warren",33036,75947,0.303129845939275,-42911
"OH","39167","Washington",7841,19901,0.282640040371999,-12060
"OH","39169","Wayne",14670,31622,0.316901408450704,-16952
"OH","39171","Williams",4287,11706,0.268054773963609,-7419
"OH","39173","Wood",26440,31734,0.45449857324578,-5294
"OH","39175","Wyandot",2484,7346,0.252695829094608,-4862
"OK","40001","Adair",1374,4753,0.224253305043251,-3379
"OK","40003","Alfalfa",216,1931,0.100605496040987,-1715
"OK","40005","Atoka",795,4068,0.163479333744602,-3273
"OK","40007","Beaver",176,1987,0.0813684697179843,-1811
"OK","40009","Beckham",958,6287,0.132229123533471,-5329
"OK","40011","Blaine",711,2884,0.197774687065369,-2173
"OK","40013","Bryan",2793,10449,0.210919800634345,-7656
"OK","40015","Caddo",2418,6473,0.271960409402767,-4055
"OK","40017","Canadian",11666,39969,0.225932022852716,-28303
"OK","40019","Carter",4002,13751,0.225426688447023,-9749
"OK","40021","Cherokee",5455,9992,0.353143005114262,-4537
"OK","40023","Choctaw",1064,4202,0.20205089251804,-3138
"OK","40025","Cimarron",70,962,0.0678294573643411,-892
"OK","40027","Cleveland",38790,62469,0.383077059816905,-23679
"OK","40029","Coal",411,1892,0.178462874511507,-1481
"OK","40031","Comanche",11439,19153,0.373921286610879,-7714
"OK","40033","Cotton",424,2054,0.171105730427764,-1630
"OK","40035","Craig",1249,4279,0.225940665701881,-3030
"OK","40037","Creek",5834,21539,0.213129726372703,-15705
"OK","40039","Custer",2102,7818,0.211895161290323,-5716
"OK","40041","Delaware",3306,11796,0.21891140246325,-8490
"OK","40043","Dewey",222,1964,0.101555352241537,-1742
"OK","40045","Ellis",155,1610,0.0878186968838527,-1455
"OK","40047","Garfield",4391,15998,0.215361224189514,-11607
"OK","40049","Garvin",1852,8243,0.18345715700842,-6391
"OK","40051","Grady",3878,17293,0.183175098011431,-13415
"OK","40053","Grant",287,1827,0.135761589403974,-1540
"OK","40055","Greer",323,1482,0.178947368421053,-1159
"OK","40057","Harmon",224,714,0.238805970149254,-490
"OK","40059","Harper",131,1307,0.0910987482614743,-1176
"OK","40061","Haskell",882,3697,0.192618475649705,-2815
"OK","40063","Hughes",961,3387,0.221021159153634,-2426
"OK","40065","Jackson",1473,5969,0.197930663800054,-4496
"OK","40067","Jefferson",365,1905,0.16079295154185,-1540
"OK","40069","Johnston",782,3081,0.202433341962206,-2299
"OK","40071","Kay",3734,12168,0.234813231040121,-8434
"OK","40073","Kingfisher",783,5151,0.131951466127401,-4368
"OK","40075","Kiowa",766,2593,0.228044060732361,-1827
"OK","40077","Latimer",797,3094,0.204831662811617,-2297
"OK","40079","LeFlore",3245,13346,0.19558796938099,-10101
"OK","40081","Lincoln",2423,10838,0.182716235578011,-8415
"OK","40083","Logan",4239,13613,0.237452386287251,-9374
"OK","40085","Love",735,2920,0.20109439124487,-2185
"OK","40087","McClain",2893,13151,0.180316629269509,-10258
"OK","40089","McCurtain",1799,8642,0.172301503687386,-6843
"OK","40091","McIntosh",2122,5501,0.278368096549915,-3379
"OK","40093","Major",310,2940,0.0953846153846154,-2630
"OK","40095","Marshall",1095,4202,0.206720785350198,-3107
"OK","40097","Mayes",3423,11550,0.228611500701262,-8127
"OK","40099","Murray",1086,4173,0.206503137478608,-3087
"OK","40101","Muskogee",7969,15029,0.34650839203409,-7060
"OK","40103","Noble",901,3707,0.195529513888889,-2806
"OK","40105","Nowata",742,3321,0.182623677085897,-2579
"OK","40107","Okfuskee",943,2791,0.252544188537761,-1848
"OK","40109","Oklahoma",112661,141429,0.443390137352906,-28768
"OK","40111","Okmulgee",4379,8926,0.329124389327321,-4547
"OK","40113","Osage",5593,12559,0.308120317320405,-6966
"OK","40115","Ottawa",2584,7627,0.253060425031828,-5043
"OK","40117","Pawnee",1341,4716,0.221396731054978,-3375
"OK","40119","Payne",8785,16644,0.345471705533053,-7859
"OK","40121","Pittsburg",3704,12740,0.225249331063002,-9036
"OK","40123","Pontotoc",3633,10420,0.258521312175336,-6787
"OK","40125","Pottawatomie",6005,17826,0.251982711594142,-11821
"OK","40127","Pushmataha",748,3581,0.172788172788173,-2833
"OK","40129","Roger Mills",151,1546,0.08898055391868,-1395
"OK","40131","Rogers",7895,30893,0.20354233268021,-22998
"OK","40133","Seminole",2067,5612,0.269175673915874,-3545
"OK","40135","Sequoyah",3061,10888,0.219442253925013,-7827
"OK","40137","Stephens",3084,14166,0.178782608695652,-11082
"OK","40139","Texas",855,4615,0.156307129798903,-3760
"OK","40141","Tillman",657,1944,0.252595155709343,-1287
"OK","40143","Tulsa",87663,143985,0.378431931205968,-56322
"OK","40145","Wagoner",6711,22967,0.22612709751331,-16256
"OK","40147","Washington",5047,15810,0.241981109459654,-10763
"OK","40149","Washita",588,3851,0.132462266276188,-3263
"OK","40151","Woods",521,2945,0.150317368724755,-2424
"OK","40153","Woodward",871,6329,0.120972222222222,-5458
"OR","41001","Baker",1781,6160,0.224279058053142,-4379
"OR","41003","Benton",28431,13030,0.685728757145269,15401
"OR","41005","Clackamas",90187,79062,0.532865777641227,11125
"OR","41007","Clatsop",8899,7794,0.533097705625112,1105
"OR","41009","Columbia",9959,12967,0.434397627148216,-3008
"OR","41011","Coos",10355,17699,0.369109574392244,-7344
"OR","41013","Crook",2591,8388,0.23599599234903,-5797
"OR","41015","Curry",4253,7157,0.372743207712533,-2904
"OR","41017","Deschutes",40222,43667,0.479466914613358,-3445
"OR","41019","Douglas",13891,34112,0.289377747224132,-20221
"OR","41021","Gilliam",221,632,0.259085580304807,-411
"OR","41023","Grant",732,3187,0.186782342434294,-2455
"OR","41025","Harney",682,2904,0.190184049079755,-2222
"OR","41027","Hood River",6359,3223,0.663640158630766,3136
"OR","41029","Jackson",43550,53083,0.450674200324941,-9533
"OR","41031","Jefferson",2892,5337,0.351440029165148,-2445
"OR","41033","Josephine",13223,26582,0.332194447933677,-13359
"OR","41035","Klamath",7080,20170,0.259816513761468,-13090
"OR","41037","Lake",628,3001,0.173050427114908,-2373
"OR","41039","Lane",100497,66218,0.602807185916084,34279
"OR","41041","Lincoln",12300,9901,0.554029097788388,2399
"OR","41043","Linn",17456,32683,0.348152137058976,-15227
"OR","41045","Malheur",2213,7141,0.236583279880265,-4928
"OR","41047","Marion",48803,54336,0.473176974762214,-5533
"OR","41049","Morrow",1004,2698,0.271204754186926,-1694
"OR","41051","Multnomah",271754,63055,0.811668742477054,208699
"OR","41053","Polk",15741,18333,0.461965134706815,-2592
"OR","41055","Sherman",202,726,0.217672413793103,-524
"OR","41057","Tillamook",5701,6486,0.467793550504636,-785
"OR","41059","Umatilla",7466,16775,0.307990594447424,-9309
"OR","41061","Union",3221,8378,0.277696353133891,-5157
"OR","41063","Wallowa",1097,2825,0.279704232534421,-1728
"OR","41065","Wasco",4634,5721,0.447513278609367,-1087
"OR","41067","Washington",137818,75903,0.644850061528816,61915
"OR","41069","Wheeler",153,583,0.207880434782609,-430
"OR","41071","Yamhill",18635,22589,0.452042499514846,-3954
"PA","42001","Adams",14077,31249,0.310572298460045,-17172
"PA","42003","Allegheny",363017,257488,0.585034770066317,105529
"PA","42005","Armstrong",6849,22676,0.231972904318374,-15827
"PA","42007","Beaver",30225,46081,0.396102534532016,-15856
"PA","42009","Bedford",3613,19455,0.156623894572568,-15842
"PA","42011","Berks",75169,93094,0.4467351705366,-17925
"PA","42013","Blair",13093,37224,0.260210266907805,-24131
"PA","42015","Bradford",6263,17957,0.258587943848059,-11694
"PA","42017","Bucks",165861,163873,0.503014551123026,1988
"PA","42019","Butler",26834,61388,0.304164494117114,-34554
"PA","42021","Cambria",17798,40510,0.305241133292173,-22712
"PA","42023","Cameron",469,1495,0.238798370672098,-1026
"PA","42025","Carbon",8917,18714,0.322717237884984,-9797
"PA","42027","Centre",36555,35099,0.510159935244369,1456
"PA","42029","Chester",140188,115582,0.54810181022012,24606
"PA","42031","Clarion",4256,12545,0.253318254865782,-8289
"PA","42033","Clearfield",7700,23909,0.243601505900218,-16209
"PA","42035","Clinton",4533,9701,0.318462835464381,-5168
"PA","42037","Columbia",8502,17387,0.328402024025648,-8885
"PA","42039","Crawford",10215,23912,0.299323116593899,-13697
"PA","42041","Cumberland",44282,65649,0.402816312050286,-21367
"PA","42043","Dauphin",64287,60620,0.514678921117311,3667
"PA","42045","Delaware",169169,106559,0.613535803400453,62610
"PA","42047","Elk",3637,9704,0.272618244509407,-6067
"PA","42049","Erie",54820,57168,0.489516733935779,-2348
"PA","42051","Fayette",17826,34388,0.341402688934002,-16562
"PA","42053","Forest",626,1680,0.271465741543799,-1054
"PA","42055","Franklin",17322,49554,0.259016687600933,-32232
"PA","42057","Fulton",904,5676,0.137386018237082,-4772
"PA","42059","Greene",4157,10394,0.285684832657549,-6237
"PA","42061","Huntingdon",4487,14369,0.237961391599491,-9882
"PA","42063","Indiana",11468,24920,0.315158843574805,-13452
"PA","42065","Jefferson",3437,14533,0.191263216471898,-11096
"PA","42067","Juniata",1810,8234,0.180207088809239,-6424
"PA","42069","Lackawanna",51593,48102,0.517508400621897,3491
"PA","42071","Lancaster",90066,137145,0.396398061713561,-47079
"PA","42073","Lawrence",13933,25323,0.354926635418789,-11390
"PA","42075","Lebanon",17860,38804,0.315191303120147,-20944
"PA","42077","Lehigh",77087,70285,0.523077653828407,6802
"PA","42079","Luzerne",51454,77508,0.398985747739644,-26054
"PA","42081","Lycoming",12926,35475,0.267060597921531,-22549
"PA","42083","McKean",3802,11159,0.25412739790121,-7357
"PA","42085","Mercer",17631,30034,0.369894052239589,-12403
"PA","42087","Mifflin",3563,14050,0.202293760290694,-10487
"PA","42089","Monroe",31930,31706,0.5017600100572,224
"PA","42091","Montgomery",251063,160803,0.609574473251009,90260
"PA","42093","Montour",2851,5274,0.350892307692308,-2423
"PA","42095","Northampton",65936,71384,0.480163122633265,-5448
"PA","42097","Northumberland",9184,24418,0.273317064460449,-15234
"PA","42099","Perry",4630,15613,0.228721039371635,-10983
"PA","42101","Philadelphia",560542,105418,0.841705207519971,455124
"PA","42103","Pike",9247,16035,0.365754291590855,-6788
"PA","42105","Potter",1300,6247,0.172253875712204,-4947
"PA","42107","Schuylkill",16724,43937,0.275696081502118,-27213
"PA","42109","Snyder",3991,11710,0.25418763136106,-7719
"PA","42111","Somerset",7367,27347,0.212219853661347,-19980
"PA","42113","Sullivan",756,2318,0.245933636955107,-1562
"PA","42115","Susquehanna",5065,13295,0.275871459694989,-8230
"PA","42117","Tioga",3642,12928,0.219794809897405,-9286
"PA","42119","Union",6138,10605,0.366600967568536,-4467
"PA","42121","Venango",5889,15254,0.278531901811474,-9365
"PA","42123","Warren",4828,12032,0.286358244365362,-7204
"PA","42125","Washington",34436,58941,0.368784604345824,-24505
"PA","42127","Wayne",6398,15269,0.295287764803618,-8871
"PA","42129","Westmoreland",59506,116427,0.338231031131169,-56921
"PA","42131","Wyoming",3573,8375,0.299045865416806,-4802
"PA","42133","York",67428,126933,0.346921450290953,-59505
"RI","44001","Bristol",14532,8910,0.619912976708472,5622
"RI","44003","Kent",37582,38141,0.496308915388984,-559
"RI","44005","Newport",22680,14975,0.602310450139424,7705
"RI","44007","Providence",141597,90321,0.610547693581352,51276
"RI","44009","Washington",33511,27074,0.553123710489395,6437
"SC","45001","Abbeville",3712,6742,0.355079395446719,-3030
"SC","45003","Aiken",25426,45981,0.356071533603148,-20555
"SC","45005","Allendale",2722,788,0.775498575498575,1934
"SC","45007","Anderson",21040,56109,0.272719024225849,-35069
"SC","45009","Bamberg",3886,2197,0.638829524905474,1689
"SC","45011","Barnwell",4395,4888,0.473446084240009,-493
"SC","45013","Beaufort",29577,39986,0.425182927705821,-10409
"SC","45015","Berkeley",30492,44223,0.408110821120257,-13731
"SC","45017","Calhoun",3569,3785,0.485314114767473,-216
"SC","45019","Charleston",89048,75233,0.542046858735946,13815
"SC","45021","Cherokee",6089,15165,0.286487249458925,-9076
"SC","45023","Chester",6582,7272,0.475097444781291,-690
"SC","45025","Chesterfield",7125,9576,0.426621160409556,-2451
"SC","45027","Clarendon",7635,7246,0.513070358174854,389
"SC","45029","Colleton",7616,9083,0.456075214084676,-1467
"SC","45031","Darlington",13866,14973,0.480807240195568,-1107
"SC","45033","Dillon",5832,5637,0.508501177086058,195
"SC","45035","Dorchester",24010,34932,0.40734959790981,-10922
"SC","45037","Edgefield",4491,6842,0.396276361069443,-2351
"SC","45039","Fairfield",6936,4024,0.632846715328467,2912
"SC","45041","Florence",26630,29498,0.474451254275941,-2868
"SC","45043","Georgetown",13234,17334,0.432936404082701,-4100
"SC","45045","Greenville",73338,125595,0.368656783942332,-52257
"SC","45047","Greenwood",10633,16881,0.386457803300138,-6248
"SC","45049","Hampton",5163,3483,0.597154753643303,1680
"SC","45051","Horry",36731,83819,0.304695147241808,-47088
"SC","45053","Jasper",7789,6100,0.560803513571891,1689
"SC","45055","Kershaw",10293,17464,0.370825377382282,-7171
"SC","45057","Lancaster",13718,23598,0.367617107942974,-9880
"SC","45059","Laurens",8845,16770,0.345305485067343,-7925
"SC","45061","Lee",5170,2789,0.649579092850861,2381
"SC","45063","Lexington",35143,79866,0.305567390378144,-44723
"SC","45065","McCormick",2479,2651,0.483235867446394,-172
"SC","45067","Marion",8522,5434,0.610633419317856,3088
"SC","45069","Marlboro",5928,4257,0.582032400589102,1671
"SC","45071","Newberry",6212,10011,0.382913147999753,-3799
"SC","45073","Oconee",7979,24096,0.248760717069369,-16117
"SC","45075","Orangeburg",26258,11909,0.687976524222496,14349
"SC","45077","Pickens",10327,36096,0.222454386834112,-25769
"SC","45079","Richland",108401,52753,0.672654727775916,55648
"SC","45081","Saluda",2809,5525,0.337053035757139,-2716
"SC","45083","Spartanburg",39888,76101,0.3438946796679,-36213
"SC","45085","Sumter",24024,18733,0.561872909698997,5291
"SC","45087","Union",4727,7058,0.401103097157403,-2331
"SC","45089","Williamsburg",9949,4863,0.671685120172833,5086
"SC","45091","York",41230,66245,0.383624098627588,-25015
"SD","46003","Aurora",340,974,0.258751902587519,-634
"SD","46005","Beadle",1912,4455,0.300298413695618,-2543
"SD","46007","Bennett",412,666,0.382189239332096,-254
"SD","46009","Bon Homme",704,2105,0.25062299750801,-1401
"SD","46011","Brookings",4879,6748,0.419626730885009,-1869
"SD","46013","Brown",5452,9613,0.361898440092931,-4161
"SD","46015","Brule",571,1565,0.267322097378277,-994
"SD","46017","Buffalo",296,171,0.633832976445396,125
"SD","46019","Butte",693,3355,0.171195652173913,-2662
"SD","46021","Campbell",105,704,0.129789864029666,-599
"SD","46023","Charles Mix",935,2382,0.281881217968043,-1447
"SD","46025","Clark",398,1139,0.258945998698764,-741
"SD","46027","Clay",2608,2109,0.552893788424846,499
"SD","46029","Codington",3174,7764,0.290181020296215,-4590
"SD","46031","Corson",535,588,0.47640249332146,-53
"SD","46033","Custer",1120,3290,0.253968253968254,-2170
"SD","46035","Davison",2355,5157,0.313498402555911,-2802
"SD","46037","Day",974,1627,0.374471357170319,-653
"SD","46039","Deuel",570,1366,0.294421487603306,-796
"SD","46041","Dewey",887,723,0.550931677018634,164
"SD","46043","Douglas",214,1338,0.137886597938144,-1124
"SD","46045","Edmunds",380,1433,0.209597352454495,-1053
"SD","46047","Fall River",821,2511,0.24639855942377,-1690
"SD","46049","Faulk",204,858,0.192090395480226,-654
"SD","46051","Grant",970,2381,0.289465831095195,-1411
"SD","46053","Gregory",391,1600,0.196383726770467,-1209
"SD","46055","Haakon",77,936,0.0760118460019743,-859
"SD","46057","Hamlin",555,2051,0.212970069071374,-1496
"SD","46059","Hand",334,1391,0.193623188405797,-1057
"SD","46061","Hanson",424,1497,0.220718375845914,-1073
"SD","46063","Harding",38,694,0.0519125683060109,-656
"SD","46065","Hughes",2449,5174,0.321264593991867,-2725
"SD","46067","Hutchinson",692,2517,0.2156435026488,-1825
"SD","46069","Hyde",125,543,0.187125748502994,-418
"SD","46071","Jackson",323,722,0.309090909090909,-399
"SD","46073","Jerauld",264,648,0.289473684210526,-384
"SD","46075","Jones",69,450,0.132947976878613,-381
"SD","46077","Kingsbury",703,1680,0.295006294586655,-977
"SD","46079","Lake",2314,4038,0.364294710327456,-1724
"SD","46081","Lawrence",3356,7411,0.311693136435404,-4055
"SD","46083","Lincoln",8076,15499,0.342566277836691,-7423
"SD","46085","Lyman",369,977,0.274145616641902,-608
"SD","46087","McCook",623,1794,0.257757550682664,-1171
"SD","46089","McPherson",192,892,0.177121771217712,-700
"SD","46091","Marshall",754,1056,0.416574585635359,-302
"SD","46093","Meade",2223,8441,0.208458364591148,-6218
"SD","46095","Mellette",238,402,0.371875,-164
"SD","46097","Miner",281,706,0.284701114488349,-425
"SD","46099","Minnehaha",30610,42043,0.421317770773402,-11433
"SD","46101","Moody",1042,1729,0.376037531577048,-687
"SD","46102","Oglala Lakota",2504,241,0.912204007285975,2263
"SD","46103","Pennington",14074,29804,0.320752996946078,-15730
"SD","46105","Perkins",188,1333,0.123602892833662,-1145
"SD","46107","Potter",215,1069,0.167445482866044,-854
"SD","46109","Roberts",1539,2142,0.418092909535452,-603
"SD","46111","Sanborn",241,819,0.227358490566038,-578
"SD","46115","Spink",919,1854,0.331410025243419,-935
"SD","46117","Stanley",329,1148,0.222748815165877,-819
"SD","46119","Sully",137,679,0.167892156862745,-542
"SD","46121","Todd",1505,487,0.755522088353414,1018
"SD","46123","Tripp",462,2069,0.182536546819439,-1607
"SD","46125","Turner",961,2937,0.246536685479733,-1976
"SD","46127","Union",2227,5288,0.296340652029275,-3061
"SD","46129","Walworth",457,1896,0.194220144496388,-1439
"SD","46135","Yankton",3301,5654,0.368620882188721,-2353
"SD","46137","Ziebach",352,368,0.488888888888889,-16
"TN","47001","Anderson",9010,19201,0.319378965651696,-10191
"TN","47003","Bedford",3384,11455,0.22804771210998,-8071
"TN","47005","Benton",1474,4715,0.238164485377282,-3241
"TN","47007","Bledsoe",896,3621,0.1983617445207,-2725
"TN","47009","Blount",12085,37385,0.244289468364665,-25300
"TN","47011","Bradley",7070,29761,0.191957861583992,-22691
"TN","47013","Campbell",2248,9860,0.185662371985464,-7612
"TN","47015","Cannon",1126,4006,0.219407638347623,-2880
"TN","47017","Carroll",2323,7731,0.231052317485578,-5408
"TN","47019","Carter",3453,16897,0.16968058968059,-13444
"TN","47021","Cheatham",3877,11295,0.255536514632217,-7418
"TN","47023","Chester",902,3827,0.190737999577078,-2925
"TN","47025","Claiborne",1831,8589,0.175719769673704,-6758
"TN","47027","Clay",707,2140,0.2483315770987,-1433
"TN","47029","Cocke",1980,9791,0.168210007645909,-7811
"TN","47031","Coffee",4741,14409,0.24757180156658,-9668
"TN","47033","Crockett",1302,3977,0.246637620761508,-2675
"TN","47035","Cumberland",5202,20410,0.203107918163361,-15208
"TN","47037","Davidson",148473,84365,0.637666532095277,64108
"TN","47039","Decatur",894,3580,0.199821189092535,-2686
"TN","47041","DeKalb",1566,5164,0.232689450222883,-3598
"TN","47043","Dickson",4718,13213,0.263119736768725,-8495
"TN","47045","Dyer",2815,10175,0.216705157813703,-7360
"TN","47047","Fayette",5865,13046,0.310136957326424,-7181
"TN","47049","Fentress",1100,6032,0.154234436343242,-4932
"TN","47051","Franklin",4372,11526,0.275003145049692,-7154
"TN","47053","Gibson",5255,13779,0.276084900704003,-8524
"TN","47055","Giles",2915,7964,0.267947421638018,-5049
"TN","47057","Grainger",1154,6618,0.148481729284611,-5464
"TN","47059","Greene",4211,18538,0.185107037671986,-14327
"TN","47061","Grundy",998,3626,0.21583044982699,-2628
"TN","47063","Hamblen",4075,15839,0.20462990860701,-11764
"TN","47065","Hamilton",55260,78661,0.412631327424377,-23401
"TN","47067","Hancock",322,1842,0.148798521256932,-1520
"TN","47069","Hardeman",4174,4912,0.459388069557561,-738
"TN","47071","Hardin",1622,8012,0.16836205106913,-6390
"TN","47073","Hawkins",3502,16611,0.174116243225774,-13109
"TN","47075","Haywood",3704,3010,0.551683050342568,694
"TN","47077","Henderson",1796,8118,0.181157958442606,-6322
"TN","47079","Henry",3061,9483,0.244021045918367,-6422
"TN","47081","Hickman",1823,5685,0.242807671816729,-3862
"TN","47083","Houston",865,2180,0.284072249589491,-1315
"TN","47085","Humphreys",1967,4928,0.285279187817259,-2961
"TN","47087","Jackson",1129,3229,0.259063790729693,-2100
"TN","47089","Jefferson",3490,14760,0.191232876712329,-11270
"TN","47091","Johnson",988,5400,0.15466499686913,-4412
"TN","47093","Knox",62861,105724,0.372874217753655,-42863
"TN","47095","Lake",577,1357,0.298345398138573,-780
"TN","47097","Lauderdale",3656,4884,0.428103044496487,-1228
"TN","47099","Lawrence",2821,12419,0.18510498687664,-9598
"TN","47101","Lewis",890,3579,0.199149697918998,-2689
"TN","47103","Lincoln",2550,10375,0.197292069632495,-7825
"TN","47105","Loudon",4916,17588,0.218450053323854,-12672
"TN","47107","McMinn",3507,14673,0.192904290429043,-11166
"TN","47109","McNairy",1847,7839,0.190687590336568,-5992
"TN","47111","Macon",1071,6260,0.146091938344019,-5189
"TN","47113","Madison",15438,21321,0.419978780706766,-5883
"TN","47115","Marion",2829,7680,0.269197830431059,-4851
"TN","47117","Marshall",2848,8167,0.258556513844757,-5319
"TN","47119","Maury",10026,23781,0.296565799982252,-13755
"TN","47121","Meigs",856,3337,0.20414977343191,-2481
"TN","47123","Monroe",3184,13361,0.192444847385917,-10177
"TN","47125","Montgomery",21686,32320,0.401547976150798,-10634
"TN","47127","Moore",496,2325,0.175824175824176,-1829
"TN","47129","Morgan",1053,5429,0.162449861153965,-4376
"TN","47131","Obion",2425,9525,0.202928870292887,-7100
"TN","47133","Overton",1943,6055,0.242935733933483,-4112
"TN","47135","Perry",597,2167,0.215991316931983,-1570
"TN","47137","Pickett",536,2019,0.209784735812133,-1483
"TN","47139","Polk",1252,5097,0.197196408883289,-3845
"TN","47141","Putnam",6847,18981,0.265099891590522,-12134
"TN","47143","Rhea",1942,8650,0.183345921450151,-6708
"TN","47145","Roane",4833,15863,0.233523386161577,-11030
"TN","47147","Robertson",6634,19393,0.254889153571291,-12759
"TN","47149","Rutherford",36627,64428,0.362446192667359,-27801
"TN","47151","Scott",934,6044,0.133849240470049,-5110
"TN","47153","Sequatchie",1051,4434,0.191613491340018,-3383
"TN","47155","Sevier",6293,28610,0.180299687705928,-22317
"TN","47157","Shelby",206640,114948,0.642561289600358,91692
"TN","47159","Smith",1688,5485,0.235326920395929,-3797
"TN","47161","Stewart",1222,3864,0.240267400707825,-2642
"TN","47163","Sullivan",11910,45577,0.207177274862143,-33667
"TN","47165","Sumner",18153,50105,0.265946848721029,-31952
"TN","47167","Tipton",5779,16893,0.254895906845448,-11114
"TN","47169","Trousdale",943,2099,0.309993425378041,-1156
"TN","47171","Unicoi",1260,5666,0.181923187987294,-4406
"TN","47173","Union",1010,5024,0.167384819356977,-4014
"TN","47175","Van Buren",539,1820,0.228486646884273,-1281
"TN","47177","Warren",3535,9535,0.270466717674063,-6000
"TN","47179","Washington",13003,34179,0.275592386927218,-21176
"TN","47181","Wayne",717,5034,0.124673969744392,-4317
"TN","47183","Weakley",2770,9001,0.235324101605641,-6231
"TN","47185","White",1842,7657,0.193915148963049,-5815
"TN","47187","Williamson",30992,68160,0.312570598676779,-37168
"TN","47189","Wilson",14356,39304,0.267536339918002,-24948
"TX","48001","Anderson",3358,13165,0.203231858621316,-9807
"TX","48003","Andrews",836,3925,0.17559336273892,-3089
"TX","48005","Angelina",7538,21666,0.25811532666758,-14128
"TX","48007","Aransas",2458,7730,0.24126423243031,-5272
"TX","48009","Archer",394,3785,0.0942809284517827,-3391
"TX","48011","Armstrong",70,924,0.0704225352112676,-854
"TX","48013","Atascosa",4635,8598,0.350260711856722,-3963
"TX","48015","Austin",2319,9637,0.193961191033791,-7318
"TX","48017","Bailey",397,1343,0.22816091954023,-946
"TX","48019","Bandera",1726,8159,0.17460799190693,-6433
"TX","48021","Bastrop",10555,16314,0.392831888049425,-5759
"TX","48023","Baylor",191,1267,0.131001371742112,-1076
"TX","48025","Bee",3443,4743,0.420596139750794,-1300
"TX","48027","Bell",37608,51780,0.420727614444892,-14172
"TX","48029","Bexar",319191,240161,0.57064424548406,79030
"TX","48031","Blanco",1244,4212,0.228005865102639,-2968
"TX","48033","Borden",31,330,0.0858725761772853,-299
"TX","48035","Bosque",1277,6325,0.16798210997106,-5048
"TX","48037","Bowie",8831,24913,0.261705784732101,-16082
"TX","48039","Brazoria",43075,72653,0.372208972763722,-29578
"TX","48041","Brazos",23041,38662,0.373417824092832,-15621
"TX","48043","Brewster",1869,2073,0.474124809741248,-204
"TX","48045","Briscoe",91,625,0.127094972067039,-534
"TX","48047","Brooks",1937,613,0.759607843137255,1324
"TX","48049","Brown",1621,12010,0.11892010857604,-10389
"TX","48051","Burleson",1491,5316,0.219039224327898,-3825
"TX","48053","Burnet",3785,14595,0.205930359085963,-10810
"TX","48055","Caldwell",4663,6516,0.417121388317381,-1853
"TX","48057","Calhoun",2118,4638,0.313499111900533,-2520
"TX","48059","Callahan",568,4858,0.104681164762256,-4290
"TX","48061","Cameron",59319,29432,0.668375567599238,29887
"TX","48063","Camp",1260,3201,0.282447881640888,-1941
"TX","48065","Carson",249,2617,0.086880669923238,-2368
"TX","48067","Cass",2250,9182,0.196815955213436,-6932
"TX","48069","Castro",526,1413,0.271273852501289,-887
"TX","48071","Chambers",2939,13278,0.181229573903928,-10339
"TX","48073","Cherokee",3466,12896,0.211832294340545,-9430
"TX","48075","Childress",253,1802,0.123114355231144,-1549
"TX","48077","Clay",536,4376,0.109120521172638,-3840
"TX","48079","Cochran",190,679,0.218642117376295,-489
"TX","48081","Coke",140,1265,0.099644128113879,-1125
"TX","48083","Coleman",387,3177,0.108585858585859,-2790
"TX","48085","Collin",139837,200395,0.411004843753674,-60558
"TX","48087","Collingsworth",145,983,0.12854609929078,-838
"TX","48089","Colorado",1977,6323,0.238192771084337,-4346
"TX","48091","Comal",14166,44996,0.23944423785538,-30830
"TX","48093","Comanche",788,4300,0.154874213836478,-3512
"TX","48095","Concho",148,885,0.143272023233301,-737
"TX","48097","Cooke",2345,13174,0.151105096977898,-10829
"TX","48099","Coryell",5057,12212,0.292836875325728,-7155
"TX","48101","Cottle",84,486,0.147368421052632,-402
"TX","48103","Crane",299,1047,0.222139673105498,-748
"TX","48105","Crockett",372,980,0.275147928994083,-608
"TX","48107","Crosby",468,1180,0.283980582524272,-712
"TX","48109","Culberson",454,280,0.618528610354223,174
"TX","48111","Dallam",222,1258,0.15,-1036
"TX","48113","Dallas",458845,261865,0.636656907771503,196980
"TX","48115","Dawson",835,2636,0.240564678766926,-1801
"TX","48117","Deaf Smith",1185,2911,0.289306640625,-1726
"TX","48119","Delta",400,1836,0.178890876565295,-1436
"TX","48121","Denton",110000,169175,0.394018089012268,-59175
"TX","48123","De Witt",1161,5510,0.17403687603058,-4349
"TX","48125","Dickens",128,755,0.144960362400906,-627
"TX","48127","Dimmit",2173,974,0.690498887829679,1199
"TX","48129","Donley",190,1225,0.134275618374558,-1035
"TX","48131","Duval",2783,1316,0.678946084410832,1467
"TX","48133","Eastland",776,6008,0.11438679245283,-5232
"TX","48135","Ector",10225,24976,0.290474702423227,-14751
"TX","48137","Edwards",302,741,0.289549376797699,-439
"TX","48139","Ellis",16197,44807,0.265507179857059,-28610
"TX","48141","El Paso",145509,54567,0.727268637917591,90942
"TX","48143","Erath",2159,11205,0.161553427117629,-9046
"TX","48145","Falls",1682,3438,0.328515625,-1756
"TX","48147","Fannin",2123,9536,0.182091088429539,-7413
"TX","48149","Fayette",2127,8648,0.197401392111369,-6521
"TX","48151","Fisher",403,1265,0.241606714628297,-862
"TX","48153","Floyd",435,1473,0.227987421383648,-1038
"TX","48155","Foard",113,383,0.227822580645161,-270
"TX","48157","Fort Bend",134475,117212,0.534294580172993,17263
"TX","48159","Franklin",665,3583,0.156544256120527,-2918
"TX","48161","Freestone",1461,5995,0.195949570815451,-4534
"TX","48163","Frio",1401,1232,0.532092669958223,169
"TX","48165","Gaines",597,3907,0.132548845470693,-3310
"TX","48167","Galveston",45503,73566,0.382156564680983,-28063
"TX","48169","Garza",224,1223,0.154803040774015,-999
"TX","48171","Gillespie",2286,10445,0.179561699787919,-8159
"TX","48173","Glasscock",34,553,0.0579216354344123,-519
"TX","48175","Goliad",973,2618,0.270955165692008,-1645
"TX","48177","Gonzales",1567,4580,0.254921099723442,-3013
"TX","48179","Gray",699,6495,0.0971643035863219,-5796
"TX","48181","Grayson",10276,35274,0.225598243688255,-24998
"TX","48183","Gregg",11623,28693,0.288297450143863,-17070
"TX","48185","Grimes",2194,7065,0.236958634841776,-4871
"TX","48187","Guadalupe",18308,36495,0.334069302775395,-18187
"TX","48189","Hale",2090,6347,0.247718383311604,-4257
"TX","48191","Hall",164,891,0.155450236966825,-727
"TX","48193","Hamilton",479,3056,0.135502121640735,-2577
"TX","48195","Hansford",171,1730,0.0899526564965807,-1559
"TX","48197","Hardeman",249,1207,0.171016483516484,-958
"TX","48199","Hardin",2779,19600,0.124178917735377,-16821
"TX","48201","Harris",706471,544960,0.56453052545446,161511
"TX","48203","Harrison",7130,18712,0.275907437504837,-11582
"TX","48205","Hartley",172,1727,0.0905739863085835,-1555
"TX","48207","Haskell",314,1403,0.182877111240536,-1089
"TX","48209","Hays",33117,33730,0.495414902688228,-613
"TX","48211","Hemphill",181,1460,0.1102985984156,-1279
"TX","48213","Henderson",5649,23574,0.193306642028539,-17925
"TX","48215","Hidalgo",118739,48608,0.709537667242317,70131
"TX","48217","Hill",2535,10075,0.201030927835052,-7540
"TX","48219","Hockley",1257,5793,0.178297872340426,-4536
"TX","48221","Hood",4001,21367,0.157718385367392,-17366
"TX","48223","Hopkins",2508,10704,0.189827429609446,-8196
"TX","48225","Houston",1978,6205,0.241720640351949,-4227
"TX","48227","Howard",1768,6635,0.210401047245032,-4867
"TX","48229","Hudspeth",324,503,0.391777509068924,-179
"TX","48231","Hunt",6301,23866,0.208870620214141,-17565
"TX","48233","Hutchinson",854,7039,0.108197136703408,-6185
"TX","48235","Irion",90,660,0.12,-570
"TX","48237","Jack",314,2973,0.0955278369333739,-2659
"TX","48239","Jackson",904,4266,0.174854932301741,-3362
"TX","48241","Jasper",2582,10578,0.196200607902736,-7996
"TX","48243","Jeff Davis",422,694,0.378136200716846,-272
"TX","48245","Jefferson",42404,42828,0.497512671297165,-424
"TX","48247","Jim Hogg",1635,430,0.791767554479419,1205
"TX","48249","Jim Wells",6688,5411,0.552772956442681,1277
"TX","48251","Johnson",10976,44370,0.19831604813356,-33394
"TX","48253","Jones",935,4815,0.162608695652174,-3880
"TX","48255","Karnes",1144,2959,0.278820375335121,-1815
"TX","48257","Kaufman",10265,29537,0.257901612984272,-19272
"TX","48259","Kendall",3633,15663,0.18827736318408,-12030
"TX","48261","Kenedy",99,84,0.540983606557377,15
"TX","48263","Kent",59,360,0.140811455847255,-301
"TX","48265","Kerr",4665,17658,0.208977287998925,-12993
"TX","48267","Kimble",206,1697,0.108250131371519,-1491
"TX","48269","King",5,149,0.0324675324675325,-144
"TX","48271","Kinney",457,936,0.328068916008614,-479
"TX","48273","Kleberg",4713,4364,0.519224413352429,349
"TX","48275","Knox",247,1078,0.186415094339623,-831
"TX","48277","Lamar",3579,14546,0.197462068965517,-10967
"TX","48279","Lamb",770,3040,0.202099737532808,-2270
"TX","48281","Lampasas",1479,6371,0.188407643312102,-4892
"TX","48283","La Salle",1125,870,0.56390977443609,255
"TX","48285","La Vaca",1170,7339,0.137501469032789,-6169
"TX","48287","Lee",1372,4996,0.215452261306533,-3624
"TX","48289","Leon",909,6391,0.124520547945205,-5482
"TX","48291","Liberty",4851,18856,0.204623107099169,-14005
"TX","48293","Limestone",1748,5747,0.233222148098732,-3999
"TX","48295","Lipscomb",135,1159,0.104327666151468,-1024
"TX","48297","Live Oak",739,3450,0.176414418715684,-2711
"TX","48299","Llano",1825,8283,0.180550059358924,-6458
"TX","48301","Loving",4,57,0.0655737704918033,-53
"TX","48303","Lubbock",27956,65566,0.298924317272941,-37610
"TX","48305","Lynn",403,1546,0.206772703950744,-1143
"TX","48307","McCulloch",480,2546,0.15862524785195,-2066
"TX","48309","McLennan",27046,48245,0.359219561434966,-21199
"TX","48311","McMullen",40,454,0.0809716599190283,-414
"TX","48313","Madison",881,3349,0.208274231678487,-2468
"TX","48315","Marion",1156,2968,0.280310378273521,-1812
"TX","48317","Martin",266,1453,0.154741128563118,-1187
"TX","48319","Mason",353,1656,0.175709308113489,-1303
"TX","48321","Matagorda",3357,8147,0.291811543810848,-4790
"TX","48323","Maverick",10397,2816,0.786876560962688,7581
"TX","48325","Medina",4624,12054,0.277251469001079,-7430
"TX","48327","Menard",153,681,0.183453237410072,-528
"TX","48329","Midland",9993,36896,0.213120348056047,-26903
"TX","48331","Milam",2042,6340,0.243617275113338,-4298
"TX","48333","Mills",242,1949,0.110451848471018,-1707
"TX","48335","Mitchell",353,1780,0.165494608532583,-1427
"TX","48337","Montague",885,7526,0.105219355605754,-6641
"TX","48339","Montgomery",45744,150188,0.233468754465835,-104444
"TX","48341","Moore",1096,3974,0.216173570019724,-2878
"TX","48343","Morris",1425,3443,0.292728019720625,-2018
"TX","48345","Motley",40,571,0.0654664484451719,-531
"TX","48347","Nacogdoches",6822,14751,0.316228619107217,-7929
"TX","48349","Navarro",3998,11984,0.250156425979227,-7986
"TX","48351","Newton",978,2961,0.248286367098248,-1983
"TX","48353","Nolan",1029,3551,0.224672489082969,-2522
"TX","48355","Nueces",49102,50704,0.491974430394966,-1602
"TX","48357","Ochiltree",274,2628,0.0944176430048243,-2354
"TX","48359","Oldham",78,850,0.084051724137931,-772
"TX","48361","Orange",5716,25385,0.183788302626925,-19669
"TX","48363","Palo Pinto",1700,8222,0.171336424108043,-6522
"TX","48365","Panola",1835,8445,0.178501945525292,-6610
"TX","48367","Parker",8329,46433,0.15209451809649,-38104
"TX","48369","Parmer",848,1911,0.307357738310982,-1063
"TX","48371","Pecos",1551,2463,0.386397608370703,-912
"TX","48373","Polk",7123,26587,0.211302284188668,-19464
"TX","48375","Potter",7620,19499,0.280983812087466,-11879
"TX","48377","Presidio",1458,652,0.690995260663507,806
"TX","48379","Rains",619,3919,0.136403702071397,-3300
"TX","48381","Randall",8340,43379,0.161256018097798,-35039
"TX","48383","Reagan",167,709,0.190639269406393,-542
"TX","48385","Real",262,1382,0.159367396593674,-1120
"TX","48387","Red River",1148,3924,0.226340694006309,-2776
"TX","48389","Reeves",1659,1417,0.539336801040312,242
"TX","48391","Refugio",1034,1830,0.361033519553073,-796
"TX","48393","Roberts",20,524,0.0367647058823529,-504
"TX","48395","Robertson",2203,4665,0.320762958648806,-2462
"TX","48397","Rockwall",9633,28396,0.253306687002025,-18763
"TX","48399","Runnels",452,3241,0.122393717844571,-2789
"TX","48401","Rusk",3935,14675,0.211445459430414,-10740
"TX","48403","Sabine",614,3992,0.133304385584021,-3378
"TX","48405","San Augustine",907,2620,0.257159058690105,-1713
"TX","48407","San Jacinto",2034,8050,0.201705672352241,-6016
"TX","48409","San Patricio",7825,13004,0.375678141053339,-5179
"TX","48411","San Saba",293,2025,0.126402070750647,-1732
"TX","48413","Schleicher",209,819,0.203307392996109,-610
"TX","48415","Scurry",733,4403,0.142718068535826,-3670
"TX","48417","Shackelford",103,1378,0.0695476029709656,-1275
"TX","48419","Shelby",1757,7171,0.196796594982079,-5414
"TX","48421","Sherman",96,807,0.106312292358804,-711
"TX","48423","Smith",22128,58631,0.274000421005708,-36503
"TX","48425","Somervell",540,3206,0.144153764014949,-2666
"TX","48427","Starr",9246,2218,0.80652477320307,7028
"TX","48429","Stephens",348,3033,0.102928127772848,-2685
"TX","48431","Sterling",70,549,0.113085621970921,-479
"TX","48433","Stonewall",135,555,0.195652173913043,-420
"TX","48435","Sutton",313,1075,0.225504322766571,-762
"TX","48437","Swisher",462,1671,0.216596343178622,-1209
"TX","48439","Tarrant",288001,345683,0.454486778899262,-57682
"TX","48441","Taylor",10047,33172,0.232467201925079,-23125
"TX","48443","Terrell",140,287,0.327868852459016,-147
"TX","48445","Terry",424,1295,0.246655031995346,-871
"TX","48447","Throckmorton",84,715,0.105131414267835,-631
"TX","48449","Titus",2538,6405,0.28379738342838,-3867
"TX","48451","Tom Green",9117,27376,0.249828734277807,-18259
"TX","48453","Travis",306475,126750,0.707426856714179,179725
"TX","48455","Trinity",1154,4737,0.195892038703106,-3583
"TX","48457","Tyler",1243,6601,0.158465068842427,-5358
"TX","48459","Upshur",2378,13198,0.152670775552131,-10820
"TX","48461","Upton",284,961,0.228112449799197,-677
"TX","48463","Uvalde",3863,4828,0.444482798297089,-965
"TX","48465","Val Verde",6920,5856,0.54164057608015,1064
"TX","48467","Van Zandt",2792,18436,0.131524401733559,-15644
"TX","48469","Victoria",8843,21253,0.293826422115896,-12410
"TX","48471","Walker",6085,12878,0.320888045140537,-6793
"TX","48473","Waller",5744,10525,0.353064109656402,-4781
"TX","48475","Ward",780,2541,0.23486901535682,-1761
"TX","48477","Washington",3381,10944,0.236020942408377,-7563
"TX","48479","Webb",42297,12946,0.765653566967761,29351
"TX","48481","Wharton",4238,10149,0.294571488149023,-5911
"TX","48483","Wheeler",194,2087,0.0850504164839982,-1893
"TX","48485","Wichita",8752,27609,0.240697450565166,-18857
"TX","48487","Wilbarger",807,3166,0.203121067203624,-2359
"TX","48489","Willacy",3416,1541,0.689126487795037,1875
"TX","48491","Williamson",84252,104029,0.447480096239132,-19777
"TX","48493","Wilson",4790,13991,0.255044992279431,-9201
"TX","48495","Winkler",420,1403,0.230389467910038,-983
"TX","48497","Wise",3412,20655,0.141770889599867,-17243
"TX","48499","Wood",2624,15681,0.143348811800055,-13057
NA,"48501","Yoakum",426,1797,0.191632928475034,-1371
NA,"48503","Young",873,6587,0.117024128686327,-5714
NA,"48505","Zapata",2056,1028,0.666666666666667,1028
NA,"48507","Zavala",2633,692,0.79187969924812,1941
"UT","49001","Beaver",264,1838,0.125594671741199,-1574
"UT","49003","Box Elder",1814,10324,0.149448014499918,-8510
"UT","49005","Cache",6705,16643,0.28717663183142,-9938
"UT","49007","Carbon",1696,5182,0.246583309101483,-3486
"UT","49009","Daggett",76,327,0.188585607940447,-251
"UT","49011","Davis",22575,46985,0.324539965497412,-24410
"UT","49013","Duchesne",500,5505,0.0832639467110741,-5005
"UT","49015","Emery",379,3402,0.100238032266596,-3023
"UT","49017","Garfield",352,1577,0.182477967858994,-1225
"UT","49019","Grand",1932,1934,0.499741334712882,-2
"UT","49021","Iron",2104,10025,0.1734685464589,-7921
"UT","49023","Juab",436,2759,0.136463223787167,-2323
"UT","49025","Kane",739,2248,0.247405423501841,-1509
"UT","49027","Millard",431,3860,0.100442787229084,-3429
"UT","49029","Morgan",572,3156,0.15343347639485,-2584
"UT","49031","Piute",31,537,0.0545774647887324,-506
"UT","49033","Rich",104,786,0.11685393258427,-682
"UT","49035","Salt Lake",154831,117901,0.567703826467008,36930
"UT","49037","San Juan",1997,2635,0.431131260794473,-638
"UT","49039","Sanpete",1026,6436,0.137496649691772,-5410
"UT","49041","Sevier",673,6455,0.0944163860830528,-5782
"UT","49043","Summit",10251,7160,0.588765722818908,3091
"UT","49045","Tooele",4015,9693,0.292894660052524,-5678
"UT","49047","Uintah",1002,9876,0.0921125206839493,-8874
"UT","49049","Utah",24579,89755,0.214975422883832,-65176
"UT","49051","Wasatch",3063,6115,0.333732839398562,-3052
"UT","49053","Washington",9583,39566,0.194978534659912,-29983
"UT","49055","Wayne",271,959,0.220325203252033,-688
"UT","49057","Weber",22187,38447,0.365916812349507,-16260
"VA","51001","Accomack",6737,8582,0.439780664534239,-1845
"VA","51003","Albemarle",33297,19232,0.633878429058235,14065
"VA","51005","Alleghany",2165,4873,0.307615799943166,-2708
"VA","51007","Amelia",2150,4704,0.313685439159615,-2554
"VA","51009","Amherst",4986,9643,0.340829858500239,-4657
"VA","51011","Appomattox",2023,5714,0.261470854336306,-3691
"VA","51013","Arlington",91879,20155,0.820099255583127,71724
"VA","51015","Augusta",8108,26152,0.23666082895505,-18044
"VA","51017","Bath",603,1548,0.280334728033473,-945
"VA","51019","Bedford",9733,30578,0.241447743792017,-20845
"VA","51021","Bland",453,2572,0.149752066115702,-2119
"VA","51023","Botetourt",4492,13369,0.251497676501876,-8877
"VA","51025","Brunswick",4473,3045,0.594972067039106,1428
"VA","51027","Buchanan",1721,7292,0.190946410740042,-5571
"VA","51029","Buckingham",3128,3969,0.440749612512329,-841
"VA","51031","Campbell",6597,19442,0.253350743116095,-12845
"VA","51033","Caroline",6425,7143,0.473540683962264,-718
"VA","51035","Carroll",2557,10653,0.193565480696442,-8096
"VA","51036","Charles City",2244,1381,0.619034482758621,863
"VA","51037","Charlotte",2153,3479,0.382279829545455,-1326
"VA","51041","Chesterfield",80993,84938,0.488112528701689,-3945
"VA","51043","Clarke",3047,4657,0.395508826583593,-1610
"VA","51045","Craig",541,2139,0.201865671641791,-1598
"VA","51047","Culpeper",7744,13341,0.367275314204411,-5597
"VA","51049","Cumberland",2032,2693,0.43005291005291,-661
"VA","51051","Dickenson",1335,4932,0.213020584011489,-3597
"VA","51053","Dinwiddie",5765,7447,0.43634574629125,-1682
"VA","51057","Essex",2541,2657,0.488841862254713,-116
"VA","51059","Fairfax",354485,157837,0.69191836384149,196648
"VA","51061","Fauquier",12960,22110,0.369546621043627,-9150
"VA","51063","Floyd",2300,5289,0.30307023323231,-2989
"VA","51065","Fluvanna",5751,7018,0.45038765760827,-1267
"VA","51067","Franklin",7254,18560,0.281010304485938,-11306
"VA","51069","Frederick",11920,26069,0.313775040143199,-14149
"VA","51071","Giles",1949,5930,0.247366417058002,-3981
"VA","51073","Gloucester",5399,13087,0.292058855349995,-7688
"VA","51075","Goochland",4884,8374,0.368381354653794,-3490
"VA","51077","Grayson",1407,5593,0.201,-4186
"VA","51079","Greene",2923,5943,0.329686442589668,-3020
"VA","51081","Greensville",2558,1737,0.59557625145518,821
"VA","51083","Halifax",6890,9698,0.415360501567398,-2808
"VA","51085","Hanover",19360,39592,0.328402768353915,-20232
"VA","51087","Henrico",93615,59674,0.610709183307348,33941
"VA","51089","Henry",8199,15207,0.350294796206101,-7008
"VA","51091","Highland",371,958,0.27915726109857,-587
"VA","51093","Isle of Wight",7673,11971,0.39060272856852,-4298
"VA","51095","James City",19091,21284,0.472842105263158,-2193
"VA","51097","King and Queen",1451,2059,0.413390313390313,-608
"VA","51099","King George",4002,7338,0.352910052910053,-3336
"VA","51101","King William",2752,5963,0.315777395295468,-3211
"VA","51103","Lancaster",2862,3520,0.448448762143529,-658
"VA","51105","Lee",1627,7542,0.177445741084088,-5915
"VA","51107","Loudoun",99909,69633,0.589287610149697,30276
"VA","51109","Louisa",6208,10507,0.371402931498654,-4299
"VA","51111","Lunenburg",2226,3206,0.40979381443299,-980
"VA","51113","Madison",2202,4418,0.332628398791541,-2216
"VA","51115","Mathews",1563,3515,0.307798345805435,-1952
"VA","51117","Mecklenburg",6571,8283,0.442372424936044,-1712
"VA","51119","Middlesex",2107,3668,0.364848484848485,-1561
"VA","51121","Montgomery",20015,19455,0.507093995439574,560
"VA","51125","Nelson",3677,4150,0.469784080746135,-473
"VA","51127","New Kent",3545,8117,0.303978734350883,-4572
"VA","51131","Northampton",3255,2686,0.547887561016664,569
"VA","51133","Northumberland",2830,5089,0.357368354590226,-2259
"VA","51135","Nottoway",2829,3712,0.432502675431891,-883
"VA","51137","Orange",5955,10511,0.361654317988583,-4556
"VA","51139","Page",2514,7824,0.243180499129425,-5310
"VA","51141","Patrick",1768,6454,0.215032838725371,-4686
"VA","51143","Pittsylvania",9195,21742,0.297216924717975,-12547
"VA","51145","Powhatan",4057,11875,0.254644740145619,-7818
"VA","51147","Prince Edward",4590,4099,0.528254114397514,491
"VA","51149","Prince George",6419,9157,0.412108371854135,-2738
"VA","51153","Prince William",83093,54065,0.605819565756281,29028
"VA","51155","Pulaski",4170,10314,0.287903893951947,-6144
"VA","51157","Rappahannock",1741,2532,0.407442078165223,-791
"VA","51159","Richmond",1347,2213,0.378370786516854,-866
"VA","51161","Roanoke",16787,30857,0.352342372596759,-14070
"VA","51163","Rockbridge",3506,6671,0.344502309128427,-3165
"VA","51165","Rockingham",9361,25269,0.270314755991915,-15908
"VA","51167","Russell",2328,9516,0.196555217831814,-7188
"VA","51169","Scott",1579,8242,0.160777924854903,-6663
"VA","51171","Shenandoah",5269,14078,0.272341965162557,-8809
"VA","51173","Smyth",2661,9747,0.214458413926499,-7086
"VA","51175","Southampton",3595,5035,0.41657010428737,-1440
"VA","51177","Spotsylvania",24204,34619,0.411471703245329,-10415
"VA","51179","Stafford",27879,33840,0.451708550041316,-5961
"VA","51181","Surry",2069,1785,0.536844836533472,284
"VA","51183","Sussex",2874,2055,0.5830797321972,819
"VA","51185","Tazewell",2895,15160,0.16034339518139,-12265
"VA","51187","Warren",5165,11762,0.305133809889526,-6597
"VA","51191","Washington",5548,19309,0.22319668503842,-13761
"VA","51193","Westmoreland",3723,4331,0.462254780233424,-608
"VA","51195","Wise",2687,11983,0.183162917518746,-9296
"VA","51197","Wythe",2765,10044,0.215863845733469,-7279
"VA","51199","York",12989,18823,0.408305042122469,-5834
"VA","51510","Alexandria",57147,13241,0.811885548673069,43906
"VA","51520","Bristol",1832,4884,0.272781417510423,-3052
"VA","51530","Buena Vista",693,1432,0.326117647058824,-739
"VA","51540","Charlottesville",17865,2951,0.858234050730208,14914
"VA","51550","Chesapeake",52554,53988,0.493270259615926,-1434
"VA","51570","Colonial Heights",2367,5681,0.294110337972167,-3314
"VA","51580","Covington",914,1349,0.403888643393725,-435
"VA","51590","Danville",11051,7306,0.602004684861361,3745
"VA","51595","Emporia",1531,792,0.659061558329746,739
"VA","51600","Fairfax City",7363,3695,0.665852776270573,3668
"VA","51610","Falls Church",5810,1323,0.814524043179588,4487
"VA","51620","Franklin City",2516,1421,0.639065278130556,1095
"VA","51630","Fredericksburg",6690,3731,0.641972939257269,2959
"VA","51640","Galax",680,1603,0.297853701270258,-923
"VA","51650","Hampton",41030,17802,0.697409573021485,23228
"VA","51660","Harrisonburg",10100,6232,0.618417830026941,3868
"VA","51670","Hopewell",4722,3885,0.548623213663297,837
"VA","51678","Lexington",1514,766,0.664035087719298,748
"VA","51680","Lynchburg",14787,17979,0.451290972349387,-3192
"VA","51683","Manassas",8395,5934,0.585874799357945,2461
"VA","51685","Manassas Park",3218,1732,0.65010101010101,1486
"VA","51690","Martinsville",3531,2149,0.621654929577465,1382
"VA","51700","Newport News",40997,23650,0.634167092053769,17347
"VA","51710","Norfolk",51429,19875,0.721263884214069,31554
"VA","51720","Norton",383,1021,0.272792022792023,-638
"VA","51730","Petersburg",12005,1448,0.892366015015238,10557
"VA","51735","Poquoson",1599,5089,0.239084928229665,-3490
"VA","51740","Portsmouth",28462,12773,0.690238874742331,15689
"VA","51750","Radford",2923,2637,0.525719424460432,286
"VA","51760","Richmond City",74640,14254,0.839651720026098,60386
"VA","51770","Roanoke City",23403,16045,0.593262015818292,7358
"VA","51775","Salem",4212,7225,0.368278394683921,-3013
"VA","51790","Staunton",5329,5129,0.509562057754829,200
"VA","51800","Suffolk",23012,17206,0.572181610224278,5806
"VA","51810","Virginia Beach",76744,84389,0.476277360937859,-7645
"VA","51820","Waynesboro",3762,4798,0.439485981308411,-1036
"VA","51830","Williamsburg",5199,1921,0.730196629213483,3278
"VA","51840","Winchester",5161,4786,0.518849904493817,375
"VT","50001","Addison",11217,5297,0.679241855395422,5920
"VT","50003","Bennington",9539,5925,0.616852043455768,3614
"VT","50005","Caledonia",6445,5533,0.538069794623476,912
"VT","50007","Chittenden",54463,18298,0.748519124256126,36165
"VT","50009","Essex",1019,1506,0.403564356435644,-487
"VT","50011","Franklin",9351,8752,0.516544219190189,599
"VT","50013","Grand Isle",2094,1487,0.584752862328958,607
"VT","50015","Lamoille",7241,3570,0.66978077883637,3671
"VT","50017","Orange",7522,4997,0.600846712996246,2525
"VT","50019","Orleans",5181,5158,0.501112293258536,23
"VT","50021","Rutland",13629,12471,0.522183908045977,1158
"VT","50023","Washington",18594,7993,0.699364350998608,10601
"VT","50025","Windham",14340,5462,0.724169275830724,8878
"VT","50027","Windsor",17544,8604,0.670949977053694,8940
"WA","53001","Adams",1118,2740,0.28978745463971,-1622
"WA","53003","Asotin",3118,5712,0.353114382785957,-2594
"WA","53005","Benton",25173,45594,0.355716647589978,-20421
"WA","53007","Chelan",10770,15070,0.416795665634675,-4300
"WA","53009","Clallam",15154,15685,0.491390771425792,-531
"WA","53011","Clark",90697,90590,0.500295112170205,107
"WA","53013","Columbia",523,1491,0.259682224428997,-968
"WA","53015","Cowlitz",17842,24066,0.425742101746683,-6224
"WA","53017","Douglas",3600,7208,0.333086602516654,-3608
"WA","53019","Ferry",1091,2178,0.333741205261548,-1087
"WA","53021","Franklin",7839,11358,0.408345053914674,-3519
"WA","53023","Garfield",276,841,0.247090420769919,-565
"WA","53025","Grant",7768,18482,0.29592380952381,-10714
"WA","53027","Grays Harbor",11378,13269,0.461638333265712,-1891
"WA","53029","Island",20766,18259,0.532120435618193,2507
"WA","53031","Jefferson",12556,5986,0.677165354330709,6570
"WA","53033","King",657149,197781,0.768658252722445,459368
"WA","53035","Kitsap",60561,46762,0.56428724504533,13799
"WA","53037","Kittitas",7190,9845,0.422072204285295,-2655
"WA","53039","Klickitat",3781,5390,0.412277832297459,-1609
"WA","53041","Lewis",7236,16273,0.307797013909567,-9037
"WA","53043","Lincoln",1238,4095,0.232139508719295,-2857
"WA","53045","Mason",11872,13539,0.467199244421707,-1667
"WA","53047","Okanogan",3980,6305,0.386971317452601,-2325
"WA","53049","Pacific",4597,5338,0.462707599396074,-741
"WA","53051","Pend Oreille",1932,4364,0.306861499364676,-2432
"WA","53053","Pierce",160306,136046,0.540931054961667,24260
"WA","53055","San Juan",7053,2651,0.726813685078318,4402
"WA","53057","Skagit",26076,24330,0.517319366742054,1746
"WA","53059","Skamania",2207,2910,0.431307406683604,-703
"WA","53061","Snohomish",167943,116433,0.590566714490674,51510
"WA","53063","Spokane",86590,103846,0.454693440315907,-17256
"WA","53065","Stevens",4348,11059,0.282209385344324,-6711
"WA","53067","Thurston",65015,46219,0.584488555657443,18796
"WA","53069","Wahkiakum",824,1328,0.382899628252788,-504
"WA","53071","Walla Walla",7550,10775,0.412005457025921,-3225
"WA","53073","Whatcom",59402,40247,0.596112354363817,19155
"WA","53075","Whitman",5521,5462,0.502685969225166,59
"WA","53077","Yakima",28484,39593,0.418408566769981,-11109
"WI","55001","Adams",3780,5983,0.387176072928403,-2203
"WI","55003","Ashland",4136,3428,0.546800634584876,708
"WI","55005","Barron",7881,13595,0.366967777984727,-5714
"WI","55007","Bayfield",4953,4125,0.545604758757436,828
"WI","55009","Brown",53358,67192,0.442621318954791,-13834
"WI","55011","Buffalo",2531,4049,0.384650455927052,-1518
"WI","55013","Burnett",2948,5412,0.352631578947368,-2464
"WI","55015","Calumet",9634,15345,0.385683974538612,-5711
"WI","55017","Chippewa",11875,17912,0.398663846644509,-6037
"WI","55019","Clark",4225,8645,0.328282828282828,-4420
"WI","55021","Columbia",13525,14160,0.488531695864186,-635
"WI","55023","Crawford",3426,3844,0.471251719394773,-418
"WI","55025","Dane",217506,71270,0.753199711887414,146236
"WI","55027","Dodge",13968,26643,0.34394622146709,-12675
"WI","55029","Door",8026,8584,0.483202889825406,-558
"WI","55031","Douglas",11342,9657,0.540120958140864,1685
"WI","55033","Dunn",9025,11487,0.439986349453978,-2462
"WI","55035","Eau Claire",27271,23301,0.539250968915605,3970
"WI","55037","Florence",666,1897,0.259851736246586,-1231
"WI","55039","Fond du Lac",17391,31044,0.359058532053267,-13653
"WI","55041","Forest",1583,2787,0.362242562929062,-1204
"WI","55043","Grant",10047,12347,0.448646959006877,-2300
"WI","55045","Green",9121,8693,0.512013023464691,428
"WI","55047","Green Lake",2700,6210,0.303030303030303,-3510
"WI","55049","Iowa",6669,4809,0.581024568740199,1860
"WI","55051","Iron",1273,2090,0.378531073446328,-817
"WI","55053","Jackson",3821,4907,0.437786434463795,-1086
"WI","55055","Jefferson",16559,23409,0.414306445156125,-6850
"WI","55057","Juneau",4100,7188,0.363217576187101,-3088
"WI","55059","Kenosha",35770,36025,0.498224110314089,-255
"WI","55061","Kewaunee",3623,6616,0.353843148744995,-2993
"WI","55063","La Crosse",32402,26384,0.551185656448814,6018
"WI","55065","Lafayette",3288,3977,0.45258086717137,-689
"WI","55067","Langlade",3260,6436,0.336221122112211,-3176
"WI","55069","Lincoln",5370,8400,0.389978213507625,-3030
"WI","55071","Manitowoc",14563,23234,0.385295129243062,-8671
"WI","55073","Marathon",26476,39010,0.404300155758483,-12534
"WI","55075","Marinette",6243,12995,0.324513982742489,-6752
"WI","55077","Marquette",2808,4712,0.373404255319149,-1904
"WI","55078","Menominee",1003,269,0.788522012578616,734
"WI","55079","Milwaukee",288986,126091,0.69622262857253,162895
"WI","55081","Monroe",7047,11442,0.381145546000325,-4395
"WI","55083","Oconto",5886,13255,0.307507444752103,-7369
"WI","55085","Oneida",8103,11677,0.409656218402427,-3574
"WI","55087","Outagamie",38087,49884,0.432949494719851,-11797
"WI","55089","Ozaukee",20167,30458,0.39836049382716,-10291
"WI","55091","Pepin",1345,2228,0.376434368877694,-883
"WI","55093","Pierce",8380,11260,0.426680244399185,-2880
"WI","55095","Polk",7568,13864,0.353116834639791,-6296
"WI","55097","Portage",18524,17310,0.516939219735447,1214
"WI","55099","Price",2671,4562,0.369279690308309,-1891
"WI","55101","Racine",42506,46620,0.476920315059579,-4114
"WI","55103","Richland",3577,4021,0.470781784680179,-444
"WI","55105","Rock",39336,31483,0.555444160465412,7853
"WI","55107","Rusk",2171,4564,0.322345953971789,-2393
"WI","55109","St. Croix",17496,26123,0.401109608198262,-8627
"WI","55111","Sauk",14692,14791,0.498321066377234,-99
"WI","55113","Sawyer",2846,4625,0.380939633248561,-1779
"WI","55115","Shawano",6056,12742,0.322161932120438,-6686
"WI","55117","Sheboygan",22636,32368,0.411533706639517,-9732
"WI","55119","Taylor",2398,6589,0.266829865361077,-4191
"WI","55121","Trempealeau",5645,7370,0.433730311179408,-1725
"WI","55123","Vernon",6351,6994,0.475908579992507,-643
"WI","55125","Vilas",4769,8169,0.36860411191838,-3400
"WI","55127","Walworth",18706,28848,0.393363334314674,-10142
"WI","55129","Washburn",3283,5404,0.377921031426269,-2121
"WI","55131","Washington",20854,51729,0.287312456084758,-30875
"WI","55133","Waukesha",79200,142521,0.357205677405388,-63321
"WI","55135","Waupaca",8303,16013,0.341462411580852,-7710
"WI","55137","Waushara",3802,7669,0.331444512248278,-3867
"WI","55139","Winnebago",37054,43447,0.460292418727718,-6393
"WI","55141","Wood",14232,21502,0.398276151564336,-7270
"WV","54001","Barbour",1213,4509,0.211988815099616,-3296
"WV","54003","Berkeley",12287,28210,0.303405190507939,-15923
"WV","54005","Boone",1783,6483,0.215702879264457,-4700
"WV","54007","Braxton",1315,3516,0.272200372593666,-2201
"WV","54009","Brooke",2549,6574,0.279403704921627,-4025
"WV","54011","Cabell",11306,19648,0.365251663759126,-8342
"WV","54013","Calhoun",456,2023,0.18394513916902,-1567
"WV","54015","Clay",566,2289,0.198248686514886,-1723
"WV","54017","Doddridge",360,2347,0.132988548208349,-1987
"WV","54019","Fayette",4246,10263,0.292645943896892,-6017
"WV","54021","Gilmer",537,1889,0.221352019785655,-1352
"WV","54023","Grant",510,4338,0.10519801980198,-3828
"WV","54025","Greenbrier",3743,9499,0.282661229421538,-5756
"WV","54027","Hampshire",1576,6646,0.191680856239358,-5070
"WV","54029","Hancock",3247,8870,0.267970619790377,-5623
"WV","54031","Hardy",1249,4544,0.215605040566201,-3295
"WV","54033","Harrison",7675,18687,0.291138760336848,-11012
"WV","54035","Jackson",2648,8959,0.228138192470061,-6311
"WV","54037","Jefferson",9458,13144,0.418458543491726,-3686
"WV","54039","Kanawha",27985,43464,0.391677980097692,-15479
"WV","54041","Lewis",1336,5245,0.203008661297675,-3909
"WV","54043","Lincoln",1435,5257,0.214435146443515,-3822
"WV","54045","Logan",2082,9866,0.17425510545698,-7784
"WV","54047","McDowell",1429,4614,0.236471951017706,-3185
"WV","54049","Marion",6926,14592,0.321870062273446,-7666
"WV","54051","Marshall",2894,9565,0.232281884581427,-6671
"WV","54053","Mason",2069,7597,0.214049244775502,-5528
"WV","54055","Mercer",4689,17362,0.212643417532085,-12673
"WV","54057","Mineral",2019,8957,0.183946793002915,-6938
"WV","54059","Mingo",1365,7876,0.147711286657288,-6511
"WV","54061","Monongalia",14568,18278,0.44352432564087,-3710
"WV","54063","Monroe",1089,4337,0.200700331736086,-3248
"WV","54065","Morgan",1568,5718,0.215207246774636,-4150
"WV","54067","Nicholas",1821,7169,0.202558398220245,-5348
"WV","54069","Ohio",5452,11077,0.329844515699679,-5625
"WV","54071","Pendleton",726,2388,0.233140655105973,-1662
"WV","54073","Pleasants",620,2342,0.209318028359217,-1722
"WV","54075","Pocahontas",924,2474,0.271924661565627,-1550
"WV","54077","Preston",2462,9501,0.205801220429658,-7039
"WV","54079","Putnam",5784,17455,0.24889194887904,-11671
"WV","54081","Raleigh",6362,21835,0.225626839734724,-15473
"WV","54083","Randolph",2724,7583,0.264286407296012,-4859
"WV","54085","Ritchie",490,3376,0.12674599068805,-2886
"WV","54087","Roane",1220,3772,0.244391025641026,-2552
"WV","54089","Summers",1186,3444,0.256155507559395,-2258
"WV","54091","Taylor",1483,4701,0.239812419146184,-3218
"WV","54093","Tucker",750,2557,0.22679165406713,-1807
"WV","54095","Tyler",505,2967,0.14544930875576,-2462
"WV","54097","Upshur",1763,6971,0.20185482024273,-5208
"WV","54099","Wayne",3334,11077,0.231351051280272,-7743
"WV","54101","Webster",554,2284,0.195207892882311,-1730
"WV","54103","Wetzel",1348,4461,0.232053709760716,-3113
"WV","54105","Wirt",383,1903,0.167541557305337,-1520
"WV","54107","Wood",8327,25168,0.248604269293924,-16841
"WV","54109","Wyoming",1061,6527,0.139826041117554,-5466
"WY","56001","Albany",6888,7601,0.475395127337981,-713
"WY","56003","Big Horn",594,4067,0.127440463419867,-3473
"WY","56005","Campbell",1324,15778,0.0774178458659806,-14454
"WY","56007","Carbon",1279,4409,0.22485935302391,-3130
"WY","56009","Converse",668,5520,0.107950872656755,-4852
"WY","56011","Crook",271,3347,0.0749032614704257,-3076
"WY","56013","Fremont",4200,11167,0.273312943320102,-6967
"WY","56015","Goshen",924,4418,0.172968925496069,-3494
"WY","56017","Hot Springs",400,1939,0.171013253527148,-1539
"WY","56019","Johnson",638,3477,0.155042527339004,-2839
"WY","56021","Laramie",11572,24844,0.317772407732865,-13272
"WY","56023","Lincoln",1105,6779,0.140157280568239,-5674
"WY","56025","Natrona",6573,23523,0.218401116427432,-16950
"WY","56027","Niobrara",115,1116,0.0934199837530463,-1001
"WY","56029","Park",2535,11115,0.185714285714286,-8580
"WY","56031","Platte",719,3437,0.173002887391723,-2718
"WY","56033","Sheridan",2926,10266,0.221801091570649,-7340
"WY","56035","Sublette",644,3409,0.158894645941278,-2765
"WY","56037","Sweetwater",3233,12153,0.210126088652021,-8920
"WY","56039","Teton",7313,3920,0.651028220421971,3393
"WY","56041","Uinta",1202,6154,0.163404023926047,-4952
"WY","56043","Washakie",532,2911,0.154516410107464,-2379
"WY","56045","Weston",294,2898,0.0921052631578947,-2604
